zip,Year,Total Population,Bachelor degree,Total Housing,Total Occupied housing units,Total Vacant housing units,Total Owner occupied housing units,Total Renter occupied housing units,Median Household Income (USD),Percentage of Rent
30002,2010,17126,3181,7762,6811,951,2807,4004,39473.4,0.516
30002,2011,16670,3478,7740,6735,1005,2884,3851,39711.2,0.498
30002,2012,16684,3633,7910,6712,1198,2937,3775,40497.4,0.477
30002,2013,16935,3717,7949,6787,1162,2947,3840,39573.2,0.483
30002,2014,16582,3946,7951,6647,1304,2851,3796,38020.0,0.477
30002,2015,16915,4052,8078,6817,1261,2889,3928,38865.6,0.486
30002,2016,16917,4090,7982,6875,1107,2835,4040,39587.8,0.506
30002,2017,17107,4303,7956,6948,1008,3047,3901,40935.6,0.49
30002,2018,17234,4274,7758,6948,810,3016,3932,43201.2,0.507
30002,2019,17369,4537,7601,7011,590,2979,4032,49385.0,0.53
30003,2010,6170,503,2506,2048,458,569,1479,36187.0,0.59
30003,2011,6675,629,2580,2094,486,641,1453,38642.0,0.563
30003,2012,6977,610,2666,2273,393,730,1543,33783.0,0.579
30003,2013,7818,647,2746,2358,388,803,1555,35357.0,0.566
30003,2014,8071,669,2870,2436,434,692,1744,36182.0,0.608
30003,2015,7914,697,2881,2495,386,775,1720,36309.0,0.597
30003,2016,8175,644,2880,2507,373,722,1785,36278.0,0.62
30003,2017,8751,623,2907,2560,347,624,1936,39773.0,0.666
30003,2018,8764,783,2824,2581,243,738,1843,45067.0,0.653
30003,2019,8356,921,2850,2635,215,655,1980,47747.0,0.695
30004,2010,99984,35832,38664,35491,3173,28928,6563,105401.19,0.17
30004,2011,103494,37388,39544,36306,3238,29513,6793,106785.88,0.172
30004,2012,108258,39468,40432,37524,2908,30397,7127,104725.88,0.176
30004,2013,111539,39846,40875,38047,2828,30508,7539,103713.25,0.184
30004,2014,116163,41949,41572,39072,2500,30660,8412,104316.38,0.202
30004,2015,119895,43544,42334,40289,2045,31431,8858,103987.94,0.209
30004,2016,122106,45973,43377,41305,2072,32614,8691,110740.88,0.2
30004,2017,124932,48848,44919,42894,2025,34332,8562,116330.88,0.191
30004,2018,129889,52632,46596,44420,2176,35841,8579,121489.81,0.184
30004,2019,135425,56983,48857,46835,2022,38417,8418,130014.25,0.172
30005,2010,66991,27351,24120,22715,1405,17408,5307,106472.92,0.22
30005,2011,68882,27643,24827,23420,1407,17721,5699,108043.58,0.23
30005,2012,72068,28495,25428,24149,1279,17805,6344,107843.75,0.249
30005,2013,74403,29046,25337,23965,1372,17477,6488,106256.0,0.256
30005,2014,77424,30207,26122,24933,1189,17761,7172,108535.92,0.275
30005,2015,79539,31904,26672,25615,1057,18162,7453,108349.17,0.279
30005,2016,82674,34265,27296,26472,824,18879,7593,112851.25,0.278
30005,2017,82849,35499,28265,27267,998,19383,7884,120767.25,0.279
30005,2018,83989,37200,29557,28440,1117,20035,8405,126231.25,0.284
30005,2019,84173,38451,30368,29052,1316,20618,8434,130339.58,0.278
30006,2010,4251,1887,2697,2288,409,196,2092,53074.0,0.776
30006,2011,4723,1945,2655,2282,373,146,2136,55242.0,0.805
30006,2012,5078,1746,2659,2282,377,181,2101,54861.0,0.79
30006,2013,5160,1896,2599,2302,297,260,2042,50553.0,0.786
30006,2014,4986,1861,2526,2183,343,277,1906,53347.0,0.755
30006,2015,4989,1913,2501,2134,367,331,1803,61306.0,0.721
30006,2016,4820,1848,2612,2216,396,313,1903,54621.0,0.729
30006,2017,4582,2041,2729,2323,406,443,1880,66117.0,0.689
30006,2018,5121,2243,2971,2493,478,477,2016,73061.0,0.679
30006,2019,5602,2525,3220,2770,450,470,2300,71676.0,0.714
30007,2010,7889,3426,2543,2446,97,2329,117,145556.0,0.046
30007,2011,7956,3559,2535,2497,38,2393,104,145766.0,0.041
30007,2012,7708,3588,2524,2453,71,2304,149,144690.0,0.059
30007,2013,8038,3741,2519,2479,40,2332,147,145483.0,0.058
30007,2014,7478,3609,2506,2463,43,2355,108,146649.0,0.043
30007,2015,7306,3734,2490,2456,34,2314,142,147143.0,0.057
30007,2016,7221,3679,2469,2439,30,2303,136,147412.0,0.055
30007,2017,7359,3493,2485,2423,62,2369,54,153313.0,0.022
30007,2018,7249,3687,2456,2398,58,2335,63,178819.0,0.026
30007,2019,7165,3743,2452,2391,61,2337,54,180536.0,0.022
30008,2010,61387,8388,24456,21508,2948,12910,8598,44851.7,0.352
30008,2011,63479,8457,24658,21737,2921,12856,8881,45791.4,0.36
30008,2012,65647,9435,25031,22112,2919,12893,9219,44889.9,0.368
30008,2013,67076,9370,25359,22344,3015,12385,9959,44005.3,0.393
30008,2014,67264,9855,25625,22398,3227,12275,10123,45048.0,0.395
30008,2015,69993,10208,26000,23256,2744,12338,10918,46353.8,0.42
30008,2016,70772,10910,26170,23672,2498,12049,11623,48727.8,0.444
30008,2017,71099,10761,26304,24033,2271,12247,11786,49998.6,0.448
30008,2018,70376,10788,26313,24138,2175,12500,11638,52537.8,0.442
30008,2019,70911,11762,26271,24499,1772,12793,11706,56134.3,0.446
30009,2010,55034,21278,23626,21572,2054,12959,8613,82245.5,0.365
30009,2011,57855,22200,24275,22338,1937,12905,9433,86145.5,0.389
30009,2012,58781,22982,24796,22962,1834,12878,10084,84045.0,0.407
30009,2013,60898,23075,24883,23271,1612,13018,10253,82324.25,0.412
30009,2014,63273,24564,25376,23899,1477,12679,11220,84478.0,0.442
30009,2015,64728,25067,25633,24347,1286,13019,11328,85637.38,0.442
30009,2016,66971,26010,26418,25001,1417,13747,11254,86467.12,0.426
30009,2017,68382,27293,26897,25360,1537,14236,11124,89912.38,0.414
30009,2018,69375,28707,27429,25598,1831,14395,11203,96967.0,0.408
30009,2019,70554,30226,28365,26517,1848,15580,10937,104441.62,0.386
30010,2010,5149,1826,2677,2568,109,1708,860,54907.0,0.321
30010,2011,5169,1997,2613,2512,101,1801,711,69167.0,0.272
30010,2012,5191,2089,2573,2434,139,1758,676,66827.0,0.263
30010,2013,5139,2020,2535,2356,179,1740,616,68816.0,0.243
30010,2014,5246,2225,2494,2396,98,1722,674,68012.0,0.27
30010,2015,5329,2327,2595,2441,154,1754,687,69169.0,0.265
30010,2016,5890,2394,2708,2589,119,1655,934,66300.0,0.345
30010,2017,6220,2271,2713,2594,119,1817,777,61295.0,0.286
30010,2018,5752,2041,2767,2711,56,1668,1043,56404.0,0.377
30010,2019,5942,2164,2790,2738,52,1700,1038,70102.0,0.372
30011,2010,60462,11431,20375,18816,1559,16399,2417,63810.56,0.119
30011,2011,62198,12026,20696,19092,1604,16794,2298,61551.67,0.111
30011,2012,62937,12325,20742,19255,1487,16588,2667,62797.33,0.129
30011,2013,62664,12236,20961,19244,1717,16728,2516,62627.44,0.12
30011,2014,64032,12578,21018,19216,1802,16706,2510,65009.78,0.119
30011,2015,64854,13662,21496,19660,1836,16754,2906,65659.22,0.135
30011,2016,67111,14832,21283,19738,1545,16626,3112,69237.67,0.146
30011,2017,68162,14939,21832,20289,1543,17097,3192,72390.89,0.146
30011,2018,70095,16179,22162,21022,1140,17572,3450,76722.22,0.156
30011,2019,70363,17289,22629,21534,1095,18017,3517,78692.44,0.155
30012,2010,56020,7794,22044,19310,2734,13462,5848,49825.89,0.265
30012,2011,57727,8048,22023,19254,2769,13541,5713,52496.56,0.259
30012,2012,58078,8125,21970,19155,2815,13426,5729,50280.67,0.261
30012,2013,58329,8410,22011,19197,2814,13086,6111,48551.0,0.278
30012,2014,58435,8206,22072,19032,3040,12943,6089,47961.78,0.276
30012,2015,58334,8417,22278,19282,2996,12829,6453,46540.44,0.29
30012,2016,58404,8761,22445,19782,2663,13189,6593,46912.56,0.294
30012,2017,59060,8902,22663,19803,2860,12864,6939,50622.78,0.306
30012,2018,60449,9836,22931,20508,2423,13104,7404,54195.67,0.323
30012,2019,63093,11299,23453,21558,1895,13811,7747,59114.11,0.33
30013,2010,80471,12729,31842,28306,3536,19890,8416,57057.0,0.264
30013,2011,82748,13194,32542,28753,3789,20273,8480,58561.58,0.261
30013,2012,82956,13551,32703,28759,3944,20144,8615,56158.67,0.263
30013,2013,84678,13751,32845,28807,4038,19805,9002,55383.92,0.274
30013,2014,84948,13540,32724,28654,4070,19858,8796,55059.58,0.269
30013,2015,85725,13897,32519,28833,3686,19604,9229,52675.83,0.284
30013,2016,85772,13912,32492,29239,3253,19867,9372,52639.33,0.288
30013,2017,86802,14131,32674,29370,3304,20309,9061,57019.08,0.277
30013,2018,86748,14349,32793,29991,2802,20406,9585,59646.0,0.292
30013,2019,90168,14750,33359,31089,2270,20701,10388,61860.08,0.311
30014,2010,90518,10111,35756,31674,4082,24002,7672,49219.62,0.215
30014,2011,93142,10603,36365,31986,4379,24355,7631,51111.56,0.21
30014,2012,94499,10826,36702,32517,4185,24344,8173,51637.12,0.223
30014,2013,94554,11161,36430,32369,4061,24163,8206,50009.06,0.225
30014,2014,95078,11343,36663,32829,3834,24195,8634,51246.19,0.235
30014,2015,95926,11490,36896,32952,3944,23777,9175,52042.38,0.249
30014,2016,96927,11415,37198,33534,3664,23534,10000,53200.94,0.269
30014,2017,97374,11729,37319,33921,3398,23980,9941,55924.25,0.266
30014,2018,99551,12124,37731,34775,2956,24708,10067,57971.44,0.267
30014,2019,100294,12565,37828,34920,2908,24910,10010,60645.56,0.265
30015,2010,3829,273,1313,1073,240,627,446,32316.0,0.34
30015,2011,3787,273,1264,1052,212,610,442,35435.0,0.35
30015,2012,3903,321,1291,1090,201,597,493,31667.0,0.382
30015,2013,3712,361,1257,1076,181,570,506,30438.0,0.403
30015,2014,3639,331,1192,1084,108,560,524,33730.0,0.44
30015,2015,3577,355,1214,1068,146,550,518,35982.0,0.427
30015,2016,3279,295,1120,957,163,502,455,37995.0,0.406
30015,2017,3154,300,1122,985,137,536,449,41182.0,0.4
30015,2018,3337,298,1117,958,159,550,408,47768.0,0.365
30015,2019,3592,384,1148,1013,135,572,441,49836.0,0.384
30016,2010,84042,10993,32404,28850,3554,22150,6700,53753.82,0.207
30016,2011,85611,11055,33063,29003,4060,22077,6926,52572.55,0.209
30016,2012,85187,10805,33070,28721,4349,21494,7227,51948.09,0.219
30016,2013,86429,11649,33178,29064,4114,21474,7590,50912.36,0.229
30016,2014,87313,11905,33279,29438,3841,21703,7735,51348.73,0.232
30016,2015,88195,12488,33128,29615,3513,21273,8342,50683.73,0.252
30016,2016,90111,12151,33107,30314,2793,20833,9481,51954.82,0.286
30016,2017,91052,12478,33403,30830,2573,21225,9605,53844.64,0.288
30016,2018,90409,12247,33516,31322,2194,21128,10194,54551.0,0.304
30016,2019,91701,11864,33757,31782,1975,21095,10687,57005.09,0.317
30017,2010,54472,11692,19824,18059,1765,16005,2054,71217.83,0.104
30017,2011,56120,12125,20427,18567,1860,16042,2525,72970.83,0.124
30017,2012,56993,12175,20498,18742,1756,16234,2508,71064.17,0.122
30017,2013,57957,12598,20258,18741,1517,15647,3094,68626.5,0.153
30017,2014,59231,12664,20104,18663,1441,15302,3361,69861.5,0.167
30017,2015,60431,13270,20227,18948,1279,15240,3708,70158.17,0.183
30017,2016,59754,13395,20114,19000,1114,15273,3727,69995.0,0.185
30017,2017,60997,14382,20236,19226,1010,15486,3740,75462.83,0.185
30017,2018,63018,14770,20673,19706,967,15979,3727,78091.33,0.18
30017,2019,63254,15974,20675,19908,767,16317,3591,78633.67,0.174
30018,2010,4687,790,1750,1639,111,1440,199,70089.0,0.114
30018,2011,4748,879,1774,1610,164,1429,181,78000.0,0.102
30018,2012,4952,942,1838,1699,139,1448,251,74196.0,0.137
30018,2013,5137,823,1820,1699,121,1471,228,68090.0,0.125
30018,2014,5133,703,1801,1666,135,1351,315,68795.0,0.175
30018,2015,5325,803,1877,1724,153,1370,354,70776.0,0.189
30018,2016,5305,831,1964,1795,169,1397,398,67043.0,0.203
30018,2017,5516,824,1926,1803,123,1421,382,64688.0,0.198
30018,2018,5505,913,1929,1819,110,1480,339,73613.0,0.176
30018,2019,5704,949,1980,1876,104,1623,253,75815.0,0.128
30019,2010,97800,18807,32420,30233,2187,26838,3395,72037.88,0.105
30019,2011,101768,20304,33364,31048,2316,27279,3769,72211.62,0.113
30019,2012,103961,20595,33449,31213,2236,26851,4362,72479.25,0.13
30019,2013,105454,21100,33862,31488,2374,27216,4272,72067.62,0.126
30019,2014,108223,21600,34242,31905,2337,27332,4573,73572.25,0.134
30019,2015,108660,22461,34648,32082,2566,26816,5266,74611.88,0.152
30019,2016,113625,24217,35154,33096,2058,27383,5713,77518.5,0.163
30019,2017,116132,24407,35933,34031,1902,28246,5785,80851.38,0.161
30019,2018,119399,26565,36673,35232,1441,28957,6275,86725.25,0.171
30019,2019,121296,28343,37975,36360,1615,29892,6468,89240.38,0.17
30021,2010,41774,7065,18316,15958,2358,7152,8806,38615.67,0.481
30021,2011,42368,7144,18015,15780,2235,7282,8498,38544.33,0.472
30021,2012,43665,7193,17699,15659,2040,7043,8616,37428.11,0.487
30021,2013,45375,7571,17695,15560,2135,6906,8654,38861.22,0.489
30021,2014,46071,7987,17217,14992,2225,6546,8446,39573.33,0.491
30021,2015,45199,8211,16907,14850,2057,6491,8359,40490.33,0.494
30021,2016,45423,8493,16964,15085,1879,6539,8546,42010.11,0.504
30021,2017,46050,8964,16875,15158,1717,6774,8384,43916.33,0.497
30021,2018,46796,9211,16756,15169,1587,6606,8563,46570.0,0.511
30021,2019,46791,9093,16640,15254,1386,6470,8784,50217.67,0.528
30022,2010,103536,41924,40173,37469,2704,27357,10112,99050.5,0.252
30022,2011,106709,42675,41016,38405,2611,27797,10608,100423.12,0.259
30022,2012,108870,44167,41878,38991,2887,27916,11075,102234.75,0.264
30022,2013,111151,44907,41808,39294,2514,27856,11438,98983.38,0.274
30022,2014,113267,46118,42621,40308,2313,27831,12477,98355.81,0.293
30022,2015,115047,47503,43068,40864,2204,27785,13079,97957.0,0.304
30022,2016,115630,48328,43281,41077,2204,27837,13240,99634.81,0.306
30022,2017,118010,49694,43731,41769,1962,28443,13326,105476.56,0.305
30022,2018,117489,51178,44431,42107,2324,28602,13505,109556.19,0.304
30022,2019,118191,52463,44732,42069,2663,29000,13069,117203.69,0.292
30023,2010,6419,2949,2601,2489,112,1140,1349,81857.0,0.519
30023,2011,7305,3159,2944,2764,180,1020,1744,87868.0,0.592
30023,2012,7002,3083,2987,2803,184,868,1935,82666.0,0.648
30023,2013,7451,3152,2971,2807,164,897,1910,79688.0,0.643
30023,2014,8071,3319,3116,2930,186,958,1972,80602.0,0.633
30023,2015,8394,3592,3214,3009,205,1019,1990,75823.0,0.619
30023,2016,8753,3734,3270,3100,170,1154,1946,71048.0,0.595
30023,2017,8621,3687,3264,3043,221,1128,1915,80469.0,0.587
30023,2018,8014,3771,3278,2966,312,1096,1870,90537.0,0.57
30023,2019,7869,3922,3360,3077,283,1218,1859,93750.0,0.553
30024,2010,134192,43770,45707,42894,2813,37631,5263,96767.62,0.115
30024,2011,138382,45651,46677,43379,3298,37450,5929,99005.33,0.127
30024,2012,143727,46251,47602,44327,3275,37886,6441,97931.86,0.135
30024,2013,146171,45837,47946,44704,3242,37966,6738,96507.29,0.141
30024,2014,147071,47962,48598,45563,3035,38625,6938,95452.24,0.143
30024,2015,151517,49266,49057,46112,2945,38634,7478,97020.29,0.152
30024,2016,154949,50798,50097,47975,2122,39760,8215,97484.95,0.164
30024,2017,156493,52728,51118,49107,2011,40826,8281,101059.62,0.162
30024,2018,160480,55874,52805,50780,2025,41791,8989,104828.29,0.17
30024,2019,164822,58194,54313,52241,2072,42698,9543,108973.33,0.176
30025,2010,40616,4735,16784,14831,1953,11527,3304,52158.33,0.197
30025,2011,41439,4780,17117,14976,2141,11701,3275,52841.44,0.191
30025,2012,43361,5422,17698,15721,1977,12050,3671,54551.67,0.207
30025,2013,43517,5541,17770,15553,2217,11921,3632,53409.44,0.204
30025,2014,45313,5380,17978,15641,2337,12026,3615,53890.11,0.201
30025,2015,45385,5545,18012,15644,2368,11888,3756,53870.22,0.209
30025,2016,46017,6077,18095,16035,2060,12143,3892,56838.33,0.215
30025,2017,45917,5572,18304,16206,2098,11945,4261,57092.22,0.233
30025,2018,46270,5892,18200,16356,1844,12237,4119,60132.78,0.226
30025,2019,46209,6542,18295,16518,1777,12653,3865,63169.56,0.211
30028,2010,53289,9864,19973,18280,1693,15931,2349,70601.31,0.118
30028,2011,55373,9734,20516,18043,2473,15832,2211,72078.69,0.108
30028,2012,56530,10284,20819,18232,2587,16041,2191,72845.69,0.105
30028,2013,59482,11057,21006,18674,2332,16105,2569,73199.23,0.122
30028,2014,61014,12044,21901,19312,2589,16574,2738,72888.38,0.125
30028,2015,62602,12412,22375,19901,2474,16764,3137,73106.38,0.14
30028,2016,65831,14625,23258,21507,1751,18182,3325,77446.62,0.143
30028,2017,67513,15590,24081,22469,1612,19163,3306,79919.54,0.137
30028,2018,70283,16581,24947,23386,1561,19985,3401,84561.23,0.136
30028,2019,71180,17062,25446,23999,1447,20600,3399,90142.38,0.134
30030,2010,42707,17253,20249,18375,1874,11160,7215,68207.91,0.356
30030,2011,42882,17933,20800,18865,1935,11496,7369,67653.82,0.354
30030,2012,43266,18501,20934,18847,2087,11352,7495,69306.36,0.358
30030,2013,42908,19004,20777,18785,1992,11340,7445,69789.18,0.358
30030,2014,43364,19109,20552,18213,2339,11059,7154,70523.0,0.348
30030,2015,44107,19870,20362,18193,2169,11274,6919,74572.64,0.34
30030,2016,44184,20332,20309,18321,1988,11211,7110,77771.27,0.35
30030,2017,44821,20558,20445,18451,1994,11752,6699,84297.18,0.328
30030,2018,46275,21596,20825,19008,1817,12140,6868,91662.18,0.33
30030,2019,47734,22759,21264,19537,1727,12483,7054,96555.73,0.332
30031,2010,5188,2201,2396,2354,42,1356,998,65859.0,0.417
30031,2011,5310,2423,2523,2451,72,1361,1090,70341.0,0.432
30031,2012,5293,2508,2607,2480,127,1342,1138,67440.0,0.437
30031,2013,5176,2585,2616,2490,126,1355,1135,67756.0,0.434
30031,2014,5665,2355,2509,2325,184,1263,1062,53234.0,0.423
30031,2015,6253,2623,2443,2303,140,1368,935,83843.0,0.383
30031,2016,5933,2388,2392,2278,114,1326,952,62833.0,0.398
30031,2017,6512,2501,2380,2309,71,1387,922,78555.0,0.387
30031,2018,6964,2746,2617,2555,62,1447,1108,78099.0,0.423
30031,2019,7102,3144,2859,2662,197,1648,1014,90648.0,0.355
30032,2010,71834,9413,33584,27684,5900,14714,12970,39445.63,0.386
30032,2011,70158,10146,33674,27391,6283,14744,12647,40302.32,0.376
30032,2012,69819,10292,33549,26709,6840,14507,12202,39269.68,0.364
30032,2013,71479,10937,33280,26872,6408,14557,12315,38652.74,0.37
30032,2014,71417,11476,32969,26821,6148,14145,12676,38528.0,0.384
30032,2015,73261,12107,33004,27276,5728,13846,13430,38797.42,0.407
30032,2016,74001,12842,33159,27956,5203,13672,14284,40271.42,0.431
30032,2017,77516,13833,33601,28984,4617,14203,14781,41872.63,0.44
30032,2018,77811,14428,33553,29362,4191,14317,15045,43109.79,0.448
30032,2019,76585,15283,33558,29280,4278,14600,14680,46823.74,0.437
30033,2010,61028,25366,29699,27197,2502,15067,12130,61464.23,0.408
30033,2011,61622,25477,30014,27142,2872,15201,11941,63034.08,0.398
30033,2012,61301,25775,29933,26955,2978,14792,12163,62486.38,0.406
30033,2013,60353,25498,29501,26375,3126,14149,12226,64777.46,0.414
30033,2014,60851,26642,29751,26390,3361,14294,12096,67343.85,0.407
30033,2015,62443,27811,29700,26463,3237,14272,12191,69522.23,0.41
30033,2016,63160,28654,29276,26374,2902,13881,12493,72819.31,0.427
30033,2017,63596,29065,29556,26625,2931,14212,12413,76400.92,0.42
30033,2018,65581,30284,29792,27129,2663,14684,12445,81364.92,0.418
30033,2019,66715,30438,29765,27300,2465,14755,12545,86328.15,0.421
30034,2010,66357,9724,26861,23396,3465,16547,6849,49835.67,0.255
30034,2011,67195,10173,27106,23651,3455,16902,6749,50908.0,0.249
30034,2012,68266,9594,27059,23404,3655,16372,7032,50437.58,0.26
30034,2013,67674,10251,26996,23111,3885,16290,6821,49512.92,0.253
30034,2014,66747,10881,26871,22517,4354,15799,6718,49472.25,0.25
30034,2015,65659,11503,26908,22583,4325,15895,6688,50977.92,0.249
30034,2016,66436,11473,27206,22695,4511,15294,7401,52252.25,0.272
30034,2017,67683,12651,27785,23178,4607,15368,7810,53298.75,0.281
30034,2018,68238,13345,27874,23648,4226,15573,8075,57581.5,0.29
30034,2019,70094,13692,28160,24367,3793,16137,8230,60731.42,0.292
30035,2010,42415,5332,17018,14675,2343,9238,5437,48234.78,0.319
30035,2011,41701,5898,17073,14611,2462,9112,5499,48781.0,0.322
30035,2012,42176,5693,17132,14475,2657,8952,5523,48273.0,0.322
30035,2013,42024,5910,17059,14208,2851,8749,5459,47708.89,0.32
30035,2014,42850,6080,17067,14368,2699,8581,5787,45515.44,0.339
30035,2015,42995,6562,17201,14773,2428,8588,6185,45373.89,0.36
30035,2016,44238,6775,17464,15273,2191,8721,6552,46699.67,0.375
30035,2017,45789,7245,17845,15901,1944,8710,7191,48378.89,0.403
30035,2018,45775,7288,17870,16272,1598,9047,7225,47400.89,0.404
30035,2019,46081,7499,18064,16435,1629,9014,7421,48003.67,0.411
30036,2010,6358,1081,2462,2235,227,1644,591,57740.0,0.24
30036,2011,6633,1024,2482,2200,282,1660,540,64615.0,0.218
30036,2012,6832,967,2481,2289,192,1699,590,61250.0,0.238
30036,2013,7168,891,2496,2312,184,1520,792,54151.0,0.317
30036,2014,6621,1017,2454,2270,184,1567,703,50485.0,0.286
30036,2015,6481,1242,2440,2239,201,1581,658,56644.0,0.27
30036,2016,6266,1439,2433,2259,174,1492,767,57120.0,0.315
30036,2017,6571,1521,2540,2295,245,1487,808,58316.0,0.318
30036,2018,6334,1836,2483,2283,200,1659,624,64159.0,0.251
30036,2019,6603,1860,2554,2408,146,1818,590,69542.0,0.231
30037,2010,3962,236,2039,1602,437,563,1039,29057.0,0.51
30037,2011,3733,243,2100,1541,559,549,992,28325.0,0.472
30037,2012,3377,228,2109,1406,703,481,925,30392.0,0.439
30037,2013,3385,250,2060,1371,689,446,925,28822.0,0.449
30037,2014,3078,211,1982,1227,755,360,867,27382.0,0.437
30037,2015,3132,276,1938,1231,707,342,889,27298.0,0.459
30037,2016,3848,314,1952,1351,601,395,956,31280.0,0.49
30037,2017,4165,352,1988,1478,510,399,1079,30250.0,0.543
30037,2018,4290,418,2020,1596,424,452,1144,38125.0,0.566
30037,2019,4428,415,2051,1701,350,422,1279,34132.0,0.624
30038,2010,37397,7515,15997,13869,2128,9703,4166,52612.0,0.26
30038,2011,39307,8173,16794,14577,2217,9723,4854,52591.0,0.289
30038,2012,39972,7662,17231,14750,2481,9596,5154,50831.8,0.299
30038,2013,41347,8449,17499,15151,2348,9564,5587,51943.2,0.319
30038,2014,42672,8513,17551,15211,2340,9179,6032,53915.0,0.344
30038,2015,44628,9444,17596,15699,1897,8852,6847,53410.0,0.389
30038,2016,45140,9018,17732,15872,1860,8556,7316,56304.6,0.413
30038,2017,42138,8858,16401,14834,1567,7635,7199,57976.0,0.439
30038,2018,41902,8532,16738,15145,1593,7669,7476,56103.0,0.447
30038,2019,41216,8771,17130,15565,1565,8083,7482,57471.0,0.437
30039,2010,69096,13077,25334,23069,2265,19593,3476,65837.73,0.137
30039,2011,69655,13280,25653,23249,2404,19491,3758,65440.64,0.146
30039,2012,69574,12966,25840,23284,2556,18745,4539,61202.55,0.176
30039,2013,70724,13547,25841,23409,2432,18723,4686,61548.18,0.181
30039,2014,71492,13704,26210,23690,2520,18546,5144,57804.18,0.196
30039,2015,73410,14193,26170,23762,2408,18127,5635,56551.55,0.215
30039,2016,74823,14471,26213,24119,2094,18236,5883,58157.91,0.224
30039,2017,77204,15169,26349,24367,1982,18436,5931,64256.73,0.225
30039,2018,78409,16188,26619,24728,1891,18609,6119,67490.82,0.23
30039,2019,80455,17667,27012,25616,1396,19983,5633,73313.82,0.209
30040,2010,89528,22362,33189,30444,2745,26264,4180,83490.55,0.126
30040,2011,94248,22970,34375,30615,3760,26569,4046,83592.95,0.118
30040,2012,98147,24350,35163,31599,3564,27367,4232,82156.27,0.12
30040,2013,102333,25034,35875,32044,3831,27556,4488,82263.36,0.125
30040,2014,105741,26246,36613,32831,3782,28128,4703,81800.64,0.128
30040,2015,109889,28224,37751,34452,3299,28984,5468,82327.32,0.145
30040,2016,113084,31715,39063,36676,2387,30994,5682,87054.27,0.145
30040,2017,117881,34780,41436,39427,2009,33171,6256,91312.64,0.151
30040,2018,124183,38815,43830,42063,1767,35073,6990,94744.82,0.159
30040,2019,130661,42858,46329,44433,1896,37162,7271,102311.5,0.157
30041,2010,78669,23372,29787,26862,2925,23291,3571,86080.74,0.12
30041,2011,82375,23802,30668,26998,3670,23131,3867,86417.39,0.126
30041,2012,85316,25344,31497,27679,3818,23637,4042,87349.0,0.128
30041,2013,87346,26188,31990,28379,3611,24161,4218,88090.83,0.132
30041,2014,89979,26815,32793,29098,3695,24633,4465,89626.91,0.136
30041,2015,93771,29329,34036,30627,3409,25544,5083,89457.96,0.149
30041,2016,98015,32168,35476,32628,2848,27312,5316,92490.7,0.15
30041,2017,103334,35628,37114,34778,2336,29229,5549,98169.35,0.15
30041,2018,108519,37762,38781,36300,2481,30114,6186,102152.65,0.16
30041,2019,113163,40575,40494,37938,2556,31399,6539,104824.35,0.161
30042,2010,7769,1598,2783,2566,217,2016,550,53350.0,0.198
30042,2011,7671,1563,2827,2613,214,1992,621,51938.0,0.22
30042,2012,7715,1684,2847,2622,225,2054,568,52546.0,0.2
30042,2013,7785,1505,2851,2649,202,1945,704,51467.0,0.247
30042,2014,7526,1604,2859,2635,224,1822,813,53357.0,0.284
30042,2015,7938,1502,2846,2664,182,1827,837,54368.0,0.294
30042,2016,7939,1603,2880,2664,216,1923,741,60556.0,0.257
30042,2017,8520,1554,2920,2697,223,1886,811,57462.0,0.278
30042,2018,8156,1648,2911,2665,246,1804,861,68347.0,0.296
30042,2019,8214,1761,2923,2713,210,1987,726,67769.0,0.248
30043,2010,123742,28719,42136,39290,2846,31136,8154,72542.75,0.194
30043,2011,126783,29552,42663,39497,3166,30566,8931,73279.88,0.209
30043,2012,128069,29910,43240,39861,3379,30583,9278,72690.56,0.215
30043,2013,130257,29263,43767,40340,3427,30635,9705,71633.5,0.222
30043,2014,130079,30394,44098,40653,3445,30764,9889,72084.25,0.224
30043,2015,134582,31572,44592,41206,3386,30352,10854,71941.88,0.243
30043,2016,137361,32976,45493,42553,2940,31202,11351,74711.69,0.25
30043,2017,140212,33325,45818,43444,2374,31654,11790,75330.75,0.257
30043,2018,143713,35718,46497,44638,1859,32307,12331,78509.56,0.265
30043,2019,145542,36928,47067,45200,1867,32475,12725,81143.12,0.27
30044,2010,131559,25391,49288,44247,5041,29131,15116,57223.52,0.307
30044,2011,131040,25652,49601,44442,5159,28334,16108,56955.62,0.325
30044,2012,133783,26285,49991,45055,4936,27393,17662,55009.62,0.353
30044,2013,136708,26176,50355,45942,4413,27226,18716,54315.05,0.372
30044,2014,139106,27243,50276,46410,3866,27087,19323,53816.52,0.384
30044,2015,142380,27462,50040,46865,3175,27167,19698,54744.71,0.394
30044,2016,146304,28120,50177,47339,2838,27648,19691,57143.29,0.392
30044,2017,149204,29810,50414,47425,2989,28924,18501,58865.43,0.367
30044,2018,150050,30301,50289,47488,2801,28537,18951,61666.71,0.377
30044,2019,151686,30229,50604,47754,2850,28812,18942,64292.24,0.374
30045,2010,107993,21355,37015,34134,2881,29948,4186,70836.5,0.113
30045,2011,110821,22363,37964,35044,2920,30317,4727,71500.9,0.125
30045,2012,112803,22631,37986,35188,2798,30329,4859,71127.3,0.128
30045,2013,114027,23621,37857,35295,2562,29833,5462,70464.5,0.144
30045,2014,117425,24643,38129,35454,2675,29645,5809,69584.3,0.152
30045,2015,119300,24252,38239,35495,2744,29141,6354,69197.0,0.166
30045,2016,120513,25142,38629,36005,2624,29635,6370,71466.6,0.165
30045,2017,125765,27207,39663,37340,2323,30977,6363,75290.0,0.16
30045,2018,129517,27919,40680,38588,2092,31819,6769,78572.9,0.166
30045,2019,133610,29309,41792,40234,1558,33255,6979,79506.2,0.167
30046,2010,90434,16529,31173,28496,2677,21574,6922,60940.91,0.222
30046,2011,89911,16473,31514,28639,2875,21410,7229,60993.27,0.229
30046,2012,91928,17105,31597,28908,2689,21602,7306,59404.27,0.231
30046,2013,93212,18036,32003,29411,2592,21632,7779,59244.73,0.243
30046,2014,95805,18139,32232,29355,2877,21508,7847,58317.82,0.243
30046,2015,96568,17863,32432,29617,2815,21307,8310,57857.27,0.256
30046,2016,98465,18565,32458,29985,2473,21455,8530,60298.0,0.263
30046,2017,101794,19955,33443,31198,2245,22221,8977,62117.91,0.268
30046,2018,103407,20040,33743,31695,2048,22485,9210,65323.45,0.273
30046,2019,107491,20511,34547,32993,1554,23363,9630,66456.91,0.279
30047,2010,123563,27346,44645,40802,3843,29784,11018,64046.76,0.247
30047,2011,125539,26778,44618,40893,3725,29169,11724,63628.67,0.263
30047,2012,127747,26804,45377,41623,3754,28646,12977,61863.95,0.286
30047,2013,129492,26332,45456,41620,3836,28084,13536,61289.19,0.298
30047,2014,130482,27318,45764,42480,3284,28633,13847,61582.24,0.303
30047,2015,132582,27848,45729,42862,2867,28884,13978,60888.76,0.306
30047,2016,134278,28501,46012,43605,2407,29203,14402,61634.43,0.313
30047,2017,137458,29029,46099,43864,2235,29449,14415,63991.43,0.313
30047,2018,137691,30243,46061,44108,1953,29526,14582,65671.14,0.317
30047,2019,139822,30845,46091,43924,2167,29566,14358,71362.0,0.312
30048,2010,2918,484,1309,1027,282,514,513,33438.0,0.392
30048,2011,3681,583,1281,1139,142,650,489,52829.0,0.382
30048,2012,3401,587,1347,1149,198,596,553,37361.0,0.411
30048,2013,3994,439,1296,1212,84,737,475,50625.0,0.367
30048,2014,3702,456,1312,1258,54,787,471,45556.0,0.359
30048,2015,3523,386,1250,1211,39,734,477,51194.0,0.382
30048,2016,3449,395,1234,1193,41,667,526,50108.0,0.426
30048,2017,3744,442,1236,1201,35,620,581,50720.0,0.47
30048,2018,3584,433,1198,1177,21,568,609,52663.0,0.508
30048,2019,3457,390,1157,1106,51,560,546,55438.0,0.472
30049,2010,6890,1273,2333,2126,207,1879,247,75925.0,0.106
30049,2011,7581,1421,2356,2159,197,1830,329,81018.0,0.14
30049,2012,7240,1403,2370,2089,281,1775,314,83086.0,0.132
30049,2013,7871,1676,2427,2223,204,1897,326,81607.0,0.134
30049,2014,8177,1953,2464,2312,152,1973,339,83775.0,0.138
30049,2015,8163,1965,2470,2323,147,1924,399,77340.0,0.162
30049,2016,7993,2023,2525,2366,159,1980,386,78214.0,0.153
30049,2017,8354,2269,2498,2443,55,2124,319,79135.0,0.128
30049,2018,8978,2428,2673,2673,0,2151,522,85121.0,0.195
30049,2019,9483,2272,2721,2721,0,2115,606,77736.0,0.223
30052,2010,128013,22682,47069,43248,3821,37584,5664,64234.33,0.12
30052,2011,131879,23956,47963,44006,3957,38106,5900,67334.39,0.123
30052,2012,132690,23933,48095,44116,3979,37820,6296,64857.5,0.131
30052,2013,134938,23934,47820,44138,3682,37094,7044,62832.67,0.147
30052,2014,136244,23481,47503,43921,3582,36487,7434,64067.44,0.156
30052,2015,137331,24154,48162,44425,3737,36386,8039,63140.06,0.167
30052,2016,139162,24465,48862,45240,3622,36804,8436,63462.78,0.173
30052,2017,141258,26376,48994,45422,3572,37066,8356,67924.5,0.171
30052,2018,145191,27861,49951,46749,3202,38160,8589,71879.83,0.172
30052,2019,148855,30667,50645,47963,2682,39323,8640,75036.83,0.171
30054,2010,24525,3326,9160,8180,980,6806,1374,52277.25,0.15
30054,2011,25192,3812,9219,8299,920,7060,1239,57175.75,0.134
30054,2012,25239,3860,9239,8329,910,6923,1406,55437.0,0.152
30054,2013,24973,3642,9128,8223,905,6716,1507,53208.75,0.165
30054,2014,24574,3440,8991,8199,792,6596,1603,55869.5,0.178
30054,2015,24872,3454,9043,8182,861,6330,1852,55623.5,0.205
30054,2016,24245,3039,9205,8149,1056,6123,2026,54153.25,0.22
30054,2017,24543,3087,9124,8263,861,6334,1929,56010.25,0.211
30054,2018,25248,3127,9174,8391,783,6591,1800,60631.75,0.196
30054,2019,26386,3320,9228,8533,695,6669,1864,62569.25,0.202
30055,2010,55157,5684,22486,19575,2911,15489,4086,48471.64,0.182
30055,2011,56829,6073,23138,20060,3078,15824,4236,49346.0,0.183
30055,2012,57940,6620,23670,20991,2679,16590,4401,50351.93,0.186
30055,2013,58395,7054,23709,21105,2604,16736,4369,49780.93,0.184
30055,2014,59306,7076,23814,21017,2797,16923,4094,50182.64,0.172
30055,2015,59265,6719,23706,20910,2796,16883,4027,51385.71,0.17
30055,2016,59760,6938,23839,21220,2619,17172,4048,53281.86,0.17
30055,2017,58868,6490,23984,21097,2887,16612,4485,56138.43,0.187
30055,2018,60095,6542,24074,21392,2682,17005,4387,58588.71,0.182
30055,2019,59439,7274,24306,21564,2742,17134,4430,61522.64,0.182
30056,2010,50276,5471,20646,17946,2700,13997,3949,47176.25,0.191
30056,2011,51252,5992,21035,18218,2817,14368,3850,48855.17,0.183
30056,2012,52479,6280,21475,18850,2625,14921,3929,49477.42,0.183
30056,2013,52568,6496,21552,19037,2515,15029,4008,48949.0,0.186
30056,2014,52956,6500,21678,19085,2593,15204,3881,50172.5,0.179
30056,2015,52882,6214,21621,18977,2644,15034,3943,51706.58,0.182
30056,2016,53553,6231,21847,19260,2587,15337,3923,52951.75,0.18
30056,2017,53160,5862,22029,19266,2763,15112,4154,55743.92,0.189
30056,2018,54283,5921,22271,19527,2744,15469,4058,58355.33,0.182
30056,2019,54251,6700,22469,19679,2790,15712,3967,62601.0,0.177
30058,2010,84453,14170,34024,29835,4189,21640,8195,55023.14,0.241
30058,2011,86525,14934,34424,30117,4307,21196,8921,54303.71,0.259
30058,2012,86173,14905,34533,29794,4739,20708,9086,52679.21,0.263
30058,2013,86012,15295,34609,29602,5007,20078,9524,54082.14,0.275
30058,2014,85529,15411,34539,29515,5024,19643,9872,51663.57,0.286
30058,2015,86297,15647,34813,30234,4579,19726,10508,52318.29,0.302
30058,2016,87622,15881,35077,31056,4021,19772,11284,53569.57,0.322
30058,2017,90019,16493,34844,31454,3390,19623,11831,56049.79,0.34
30058,2018,92318,17572,35028,32192,2836,19731,12461,57828.0,0.356
30058,2019,94691,18377,35337,33109,2228,19979,13130,61688.29,0.372
30060,2010,82517,13774,36969,31564,5405,13327,18237,42036.0,0.493
30060,2011,82676,14162,37157,31888,5269,13197,18691,41818.5,0.503
30060,2012,82665,14873,37496,31759,5737,12763,18996,41356.88,0.507
30060,2013,84261,14971,37742,32110,5632,12492,19618,40488.62,0.52
30060,2014,85553,15455,37765,32285,5480,12990,19295,41009.69,0.511
30060,2015,88635,16484,38158,33395,4763,13134,20261,43523.12,0.531
30060,2016,90856,17191,38628,34240,4388,12914,21326,47399.31,0.552
30060,2017,90100,17212,38152,34058,4094,12846,21212,49102.5,0.556
30060,2018,89949,18035,38103,34461,3642,13421,21040,52273.25,0.552
30060,2019,90252,19972,38211,35036,3175,13518,21518,54996.25,0.563
30061,2010,4484,632,2155,1896,259,657,1239,34583.0,0.575
30061,2011,4254,753,2011,1760,251,600,1160,37226.0,0.577
30061,2012,4076,784,1941,1700,241,672,1028,34846.0,0.53
30061,2013,3540,686,1860,1528,332,604,924,38140.0,0.497
30061,2014,3580,621,1846,1518,328,700,818,34247.0,0.443
30061,2015,3864,727,1931,1637,294,728,909,39362.0,0.471
30061,2016,4369,750,2089,1830,259,709,1121,40192.0,0.537
30061,2017,4653,796,2021,1783,238,660,1123,41972.0,0.556
30061,2018,4665,928,2026,1828,198,709,1119,45347.0,0.552
30061,2019,4580,1005,2093,1885,208,748,1137,45298.0,0.543
30062,2010,134675,46946,55086,51337,3749,36826,14511,85738.6,0.263
30062,2011,134556,47819,55338,51716,3622,36413,15303,85392.24,0.277
30062,2012,134338,47344,55042,51265,3777,35862,15403,84380.76,0.28
30062,2013,133961,47648,54983,51271,3712,35390,15881,83436.56,0.289
30062,2014,133886,47615,54464,51080,3384,35280,15800,85141.12,0.29
30062,2015,134458,48587,54441,51446,2995,35410,16036,85309.36,0.295
30062,2016,135784,50002,54680,51706,2974,35274,16432,89151.08,0.301
30062,2017,137631,51389,54403,51305,3098,35357,15948,93830.04,0.293
30062,2018,136251,52810,54260,51380,2880,35657,15723,100401.08,0.29
30062,2019,135998,54636,54733,51981,2752,35954,16027,102998.56,0.293
30063,2010,4432,241,1918,1534,384,499,1035,31780.0,0.54
30063,2011,4556,227,1915,1576,339,557,1019,33750.0,0.532
30063,2012,5014,176,1975,1559,416,509,1050,31271.0,0.532
30063,2013,5732,175,2056,1671,385,539,1132,30414.0,0.551
30063,2014,5176,197,2081,1690,391,573,1117,28944.0,0.537
30063,2015,5567,237,2171,1825,346,614,1211,27005.0,0.558
30063,2016,5394,237,2112,1797,315,524,1273,26475.0,0.603
30063,2017,5035,231,2124,1847,277,450,1397,26719.0,0.658
30063,2018,5279,290,2099,1859,240,496,1363,27216.0,0.649
30063,2019,5366,287,2069,1887,182,460,1427,29016.0,0.69
30064,2010,101594,27637,39817,36483,3334,28258,8225,71480.87,0.207
30064,2011,102621,28448,40080,36860,3220,28054,8806,72406.93,0.22
30064,2012,104160,28354,40129,36891,3238,27831,9060,71922.33,0.226
30064,2013,105256,28325,40491,37029,3462,27848,9181,70138.93,0.227
30064,2014,105306,28533,40477,37155,3322,26965,10190,70344.27,0.252
30064,2015,106966,28961,40962,37998,2964,27443,10555,72265.53,0.258
30064,2016,110516,29869,41426,38614,2812,27925,10689,75154.8,0.258
30064,2017,110680,30324,41452,38579,2873,28054,10525,78330.0,0.254
30064,2018,110830,31081,41716,39125,2591,28388,10737,82675.8,0.257
30064,2019,111929,32426,42058,39537,2521,29137,10400,85866.73,0.247
30065,2010,6022,1042,2871,2478,393,520,1958,33655.0,0.682
30065,2011,6082,1047,2952,2572,380,515,2057,33252.0,0.697
30065,2012,6785,1052,3061,2713,348,568,2145,35442.0,0.701
30065,2013,6640,1214,3126,2818,308,516,2302,34185.0,0.736
30065,2014,6466,1210,3093,2840,253,461,2379,35543.0,0.769
30065,2015,7059,1218,3113,2982,131,502,2480,39156.0,0.797
30065,2016,7285,1358,3190,3085,105,606,2479,48419.0,0.777
30065,2017,7001,1425,3132,3055,77,552,2503,49619.0,0.799
30065,2018,7165,1526,3121,3046,75,621,2425,54196.0,0.777
30065,2019,6895,1527,3186,3012,174,573,2439,51744.0,0.766
30066,2010,114213,35411,44828,42681,2147,33029,9652,82684.21,0.215
30066,2011,114838,36061,45350,43034,2316,32746,10288,83038.79,0.227
30066,2012,115683,36516,45279,42949,2330,32121,10828,82931.53,0.239
30066,2013,115115,36957,45304,42800,2504,32155,10645,84059.47,0.235
30066,2014,115289,37247,45187,42898,2289,32513,10385,86172.79,0.23
30066,2015,116393,37273,45632,43563,2069,32660,10903,86518.79,0.239
30066,2016,118695,38743,45974,44019,1955,32847,11172,87674.74,0.243
30066,2017,121043,40137,46478,44266,2212,33189,11077,92971.74,0.238
30066,2018,121362,41920,46927,44771,2156,33521,11250,94880.42,0.24
30066,2019,122614,43214,47461,45357,2104,33877,11480,98948.63,0.242
30067,2010,64171,20622,32038,27264,4774,12064,15200,58286.0,0.474
30067,2011,64447,20959,32203,27381,4822,12112,15269,57507.86,0.474
30067,2012,65501,20766,32208,27453,4755,11971,15482,57430.93,0.481
30067,2013,66701,21029,32178,27810,4368,11950,15860,55224.14,0.493
30067,2014,68779,21921,31954,28147,3807,11850,16297,57205.79,0.51
30067,2015,69251,22404,31777,28378,3399,11857,16521,58280.64,0.52
30067,2016,70328,22858,31920,28728,3192,11986,16742,61814.43,0.524
30067,2017,68610,23320,31625,28623,3002,11972,16651,63603.57,0.527
30067,2018,68979,24310,31683,28735,2948,11997,16738,68170.64,0.528
30067,2019,69225,25038,31985,28991,2994,12168,16823,70963.86,0.526
30068,2010,55415,23237,23090,21651,1439,17580,4071,95761.55,0.176
30068,2011,56347,23492,23034,21800,1234,17483,4317,95278.0,0.187
30068,2012,56170,23434,22789,21520,1269,17063,4457,95007.64,0.196
30068,2013,56610,23478,22671,21618,1053,16694,4924,93308.73,0.217
30068,2014,56246,23523,22425,21432,993,16443,4989,95417.91,0.222
30068,2015,55775,23782,22474,21572,902,16381,5191,96106.36,0.231
30068,2016,55277,24135,22535,21583,952,16445,5138,99905.18,0.228
30068,2017,55549,24074,22748,21583,1165,16345,5238,103125.91,0.23
30068,2018,55760,25242,22719,21567,1152,16488,5079,111245.45,0.224
30068,2019,55191,25490,22871,21509,1362,16489,5020,113860.45,0.219
30069,2010,4432,241,1918,1534,384,499,1035,31780.0,0.54
30069,2011,4556,227,1915,1576,339,557,1019,33750.0,0.532
30069,2012,5014,176,1975,1559,416,509,1050,31271.0,0.532
30069,2013,5732,175,2056,1671,385,539,1132,30414.0,0.551
30069,2014,5176,197,2081,1690,391,573,1117,28944.0,0.537
30069,2015,5567,237,2171,1825,346,614,1211,27005.0,0.558
30069,2016,5394,237,2112,1797,315,524,1273,26475.0,0.603
30069,2017,5035,231,2124,1847,277,450,1397,26719.0,0.658
30069,2018,5279,290,2099,1859,240,496,1363,27216.0,0.649
30069,2019,5366,287,2069,1887,182,460,1427,29016.0,0.69
30070,2010,6543,379,2595,2307,288,1490,817,39558.0,0.315
30070,2011,6293,536,2642,2207,435,1430,777,38243.0,0.294
30070,2012,6301,488,2611,2185,426,1348,837,39303.0,0.321
30070,2013,5997,703,2575,2017,558,1192,825,38938.0,0.32
30070,2014,6120,720,2592,2032,560,1297,735,45185.0,0.284
30070,2015,5584,719,2483,1961,522,1265,696,42566.0,0.28
30070,2016,5900,698,2407,2044,363,1145,899,46786.0,0.373
30070,2017,6020,848,2456,2137,319,1275,862,49855.0,0.351
30070,2018,6156,719,2473,2290,183,1412,878,44474.0,0.355
30070,2019,5929,655,2440,2239,201,1289,950,43031.0,0.389
30071,2010,49017,10619,19976,17872,2104,11038,6834,54281.0,0.342
30071,2011,51380,10730,20453,18060,2393,10796,7264,55792.67,0.355
30071,2012,51679,10725,19786,17655,2131,10078,7577,53643.11,0.383
30071,2013,53707,10872,20208,18119,2089,10076,8043,56159.67,0.398
30071,2014,56770,11393,20623,18879,1744,9920,8959,53436.11,0.434
30071,2015,56938,11480,20801,19134,1667,9871,9263,53237.22,0.445
30071,2016,57866,11930,21271,19853,1418,9896,9957,56023.89,0.468
30071,2017,57626,12117,21316,19806,1510,10079,9727,56714.22,0.456
30071,2018,56795,12042,21413,20095,1318,9960,10135,58850.22,0.473
30071,2019,57795,13034,21506,20399,1107,10097,10302,62313.44,0.479
30072,2010,12459,2353,5471,4645,826,2767,1878,45564.5,0.343
30072,2011,12832,2576,5536,4652,884,2804,1848,48546.5,0.334
30072,2012,12631,2387,5457,4557,900,2869,1688,46884.5,0.309
30072,2013,13084,2352,5438,4654,784,2831,1823,46336.0,0.335
30072,2014,12999,2011,5409,4695,714,2776,1919,42651.5,0.355
30072,2015,13781,1957,5499,4773,726,2632,2141,39934.5,0.389
30072,2016,13778,2161,5482,4902,580,2604,2298,39415.5,0.419
30072,2017,14442,2267,5644,5026,618,2578,2448,42050.5,0.434
30072,2018,14147,2360,5629,4856,773,2602,2254,44893.0,0.4
30072,2019,14682,2377,5678,4943,735,2492,2451,46766.0,0.432
30074,2010,4085,537,1836,1471,365,1161,310,48431.0,0.169
30074,2011,4277,553,1833,1520,313,1198,322,46745.0,0.176
30074,2012,4394,567,1844,1518,326,1194,324,46556.0,0.176
30074,2013,4691,549,1827,1492,335,1155,337,46058.0,0.184
30074,2014,4797,647,1825,1495,330,1158,337,38281.0,0.185
30074,2015,4932,657,1825,1589,236,1174,415,41793.0,0.227
30074,2016,5328,725,1876,1678,198,1168,510,43298.0,0.272
30074,2017,5579,796,1796,1677,119,1191,486,47010.0,0.271
30074,2018,5524,911,1775,1679,96,1208,471,55038.0,0.265
30074,2019,5294,911,1761,1647,114,1197,450,55143.0,0.256
30075,2010,92610,35692,35883,34021,1862,29032,4989,103568.31,0.139
30075,2011,93450,37034,36354,34545,1809,29357,5188,103157.06,0.143
30075,2012,95966,39103,36792,35101,1691,29444,5657,103500.0,0.154
30075,2013,98785,41068,37470,35928,1542,29959,5969,104542.38,0.159
30075,2014,97855,40691,37281,35829,1452,29897,5932,106672.44,0.159
30075,2015,99495,41990,37759,36249,1510,30168,6081,108883.31,0.161
30075,2016,100200,42658,37614,36067,1547,30083,5984,113355.94,0.159
30075,2017,100603,43700,37936,36284,1652,30435,5849,117574.06,0.154
30075,2018,101926,44164,38696,36689,2007,30905,5784,124792.0,0.149
30075,2019,103124,46155,38934,36976,1958,31590,5386,128930.38,0.138
30076,2010,82477,29352,34576,31637,2939,21557,10080,77870.54,0.292
30076,2011,84906,30339,34992,32228,2764,21628,10600,80175.38,0.303
30076,2012,85513,31971,35701,32784,2917,21700,11084,77887.15,0.31
30076,2013,88605,33083,36188,33446,2742,21926,11520,77778.08,0.318
30076,2014,90312,33854,36304,34021,2283,21798,12223,78948.23,0.337
30076,2015,92275,33881,36623,34627,1996,21884,12743,81607.54,0.348
30076,2016,93414,34175,36526,34588,1938,21895,12693,82733.62,0.348
30076,2017,96103,34805,36665,35098,1567,22428,12670,85950.0,0.346
30076,2018,96189,35570,37251,35353,1898,22597,12756,88705.85,0.342
30076,2019,96878,36890,37598,35322,2276,23127,12195,94120.08,0.324
30077,2010,3720,920,1689,1555,134,551,1004,50298.0,0.594
30077,2011,3920,860,1726,1521,205,486,1035,50474.0,0.6
30077,2012,3745,954,1759,1552,207,478,1074,50108.0,0.611
30077,2013,4080,964,1732,1534,198,491,1043,48117.0,0.602
30077,2014,3919,926,1731,1542,189,455,1087,46958.0,0.628
30077,2015,3843,848,1731,1587,144,407,1180,47326.0,0.682
30077,2016,4016,894,1713,1608,105,411,1197,45500.0,0.699
30077,2017,4451,1002,1712,1658,54,398,1260,47428.0,0.736
30077,2018,4592,1163,1777,1728,49,443,1285,48300.0,0.723
30077,2019,4280,1039,1692,1616,76,412,1204,50326.0,0.712
30078,2010,67318,14878,24128,22188,1940,19875,2313,72340.22,0.096
30078,2011,68408,15175,24278,22203,2075,19365,2838,75264.44,0.117
30078,2012,68797,15677,24482,22452,2030,19071,3381,71507.78,0.138
30078,2013,69885,16260,24146,22331,1815,18645,3686,71118.89,0.153
30078,2014,70422,16165,24139,22435,1704,18298,4137,68870.22,0.171
30078,2015,71671,17029,24232,22385,1847,17949,4436,70627.89,0.183
30078,2016,71034,16571,23789,22174,1615,17820,4354,70285.67,0.183
30078,2017,70546,17244,23588,22006,1582,17572,4434,74843.89,0.188
30078,2018,72143,17550,23832,22349,1483,17522,4827,77272.33,0.203
30078,2019,73179,18307,23896,22587,1309,17889,4698,79509.78,0.197
30079,2010,15504,4467,8096,7035,1061,3237,3798,40877.75,0.469
30079,2011,15711,4291,8189,7121,1068,3234,3887,39146.0,0.475
30079,2012,16298,4431,8168,7050,1118,3213,3837,41790.5,0.47
30079,2013,16136,4525,8070,6922,1148,3065,3857,42529.25,0.478
30079,2014,16214,5000,8106,6874,1232,3012,3862,45130.5,0.476
30079,2015,17053,5519,8046,6987,1059,3158,3829,46956.5,0.476
30079,2016,17507,5866,7984,6990,994,3020,3970,48862.25,0.497
30079,2017,17431,6064,8197,7249,948,3080,4169,51011.5,0.509
30079,2018,18051,6276,8250,7348,902,3154,4194,57937.5,0.508
30079,2019,18620,6310,8173,7422,751,3113,4309,61506.75,0.527
30080,2010,90229,27932,46535,40903,5632,18791,22112,55936.21,0.475
30080,2011,91481,28841,46723,40989,5734,18527,22462,55158.63,0.481
30080,2012,92079,29576,46984,41243,5741,18218,23025,55942.89,0.49
30080,2013,94765,30387,47165,41815,5350,17855,23960,57426.11,0.508
30080,2014,96786,31814,47683,42748,4935,17639,25109,57078.95,0.527
30080,2015,97947,33110,48082,43090,4992,17715,25375,59165.79,0.528
30080,2016,99557,34664,48931,44355,4576,18560,25795,62889.26,0.527
30080,2017,101096,35779,49674,44796,4878,19213,25583,66319.42,0.515
30080,2018,103833,37519,50927,45720,5207,20108,25612,68738.63,0.503
30080,2019,104847,38905,51752,46780,4972,20427,26353,72616.95,0.509
30081,2010,4512,543,2150,1760,390,948,812,39719.0,0.378
30081,2011,4539,579,2192,1701,491,878,823,38145.0,0.375
30081,2012,4417,635,2155,1654,501,774,880,38944.0,0.408
30081,2013,4474,665,2126,1617,509,746,871,41907.0,0.41
30081,2014,4284,724,2142,1713,429,709,1004,36157.0,0.469
30081,2015,4711,746,2134,1782,352,662,1120,39492.0,0.525
30081,2016,5255,861,2182,1927,255,681,1246,45085.0,0.571
30081,2017,5123,924,2193,1871,322,755,1116,51506.0,0.509
30081,2018,5605,1103,2362,2037,325,890,1147,54568.0,0.486
30081,2019,6146,1171,2349,2107,242,888,1219,59093.0,0.519
30082,2010,63430,17143,27600,24481,3119,17016,7465,63965.8,0.27
30082,2011,65357,18209,27805,24633,3172,17011,7622,64034.1,0.274
30082,2012,63295,18719,27527,24331,3196,16420,7911,65861.1,0.287
30082,2013,63737,18958,27657,24504,3153,15980,8524,67980.3,0.308
30082,2014,65877,19692,28002,25054,2948,15852,9202,66197.3,0.329
30082,2015,67264,20241,28009,25396,2613,15843,9553,63708.4,0.341
30082,2016,67166,20548,28428,26042,2386,16074,9968,65324.1,0.351
30082,2017,69715,20789,29245,26836,2409,16536,10300,68931.0,0.352
30082,2018,71597,21434,29734,27471,2263,17078,10393,71740.4,0.35
30082,2019,72282,22141,30198,28158,2040,17216,10942,76176.2,0.362
30083,2010,103847,18193,45291,38873,6418,20978,17895,46908.43,0.395
30083,2011,102017,18543,45023,38433,6590,20844,17589,44924.52,0.391
30083,2012,104966,18590,44730,38535,6195,20559,17976,43342.86,0.402
30083,2013,106991,19273,44632,38157,6475,19973,18184,43379.81,0.407
30083,2014,108827,19691,44251,38144,6107,19418,18726,43066.67,0.423
30083,2015,110807,20109,44138,38310,5828,19306,19004,42974.48,0.431
30083,2016,113201,20382,44778,39549,5229,19291,20258,44515.1,0.452
30083,2017,114451,21165,45181,39991,5190,19608,20383,47338.43,0.451
30083,2018,115852,22297,44829,40059,4770,19624,20435,49622.57,0.456
30083,2019,115167,22299,44708,40054,4654,19560,20494,52787.38,0.458
30084,2010,90852,25022,40006,35787,4219,21800,13987,57424.88,0.35
30084,2011,93529,25743,40324,35955,4369,21675,14280,59054.41,0.354
30084,2012,94865,25573,40653,36378,4275,21468,14910,58447.24,0.367
30084,2013,95574,25317,40263,35606,4657,20485,15121,57684.12,0.376
30084,2014,96821,25822,40344,35464,4880,19984,15480,60032.06,0.384
30084,2015,95316,26714,39903,35332,4571,20383,14949,60093.41,0.375
30084,2016,97609,27818,40561,36412,4149,21040,15372,61633.82,0.379
30084,2017,100264,28472,40878,37056,3822,21121,15935,62644.88,0.39
30084,2018,101643,29399,40806,37688,3118,21431,16257,66409.65,0.398
30084,2019,101529,29164,40396,37509,2887,21321,16188,69004.35,0.401
30085,2010,6493,2893,2765,2621,144,2407,214,78512.0,0.077
30085,2011,6636,3047,2768,2632,136,2427,205,84120.0,0.074
30085,2012,6679,3131,2811,2652,159,2443,209,87661.0,0.074
30085,2013,6462,3008,2749,2537,212,2326,211,91206.0,0.077
30085,2014,6764,2776,2791,2535,256,2245,290,90017.0,0.104
30085,2015,6678,2818,2797,2492,305,2292,200,92734.0,0.072
30085,2016,7028,3203,2925,2659,266,2461,198,100583.0,0.068
30085,2017,7201,3188,2962,2687,275,2401,286,91528.0,0.097
30085,2018,7280,3107,2979,2766,213,2407,359,95360.0,0.121
30085,2019,6785,3146,2889,2687,202,2389,298,99337.0,0.103
30086,2010,5358,518,2248,1782,466,1141,641,48782.0,0.285
30086,2011,5327,550,2222,1786,436,1142,644,46528.0,0.29
30086,2012,5649,565,2224,1848,376,1185,663,42500.0,0.298
30086,2013,5680,710,2272,1867,405,1108,759,39966.0,0.334
30086,2014,5390,822,2273,1954,319,1120,834,39289.0,0.367
30086,2015,5241,1181,2279,1902,377,1227,675,41589.0,0.296
30086,2016,5273,1113,2180,1889,291,1132,757,40895.0,0.347
30086,2017,5624,1078,2128,1857,271,1108,749,41963.0,0.352
30086,2018,5492,1047,2007,1756,251,985,771,44042.0,0.384
30086,2019,5572,975,2067,1875,192,1103,772,46448.0,0.373
30087,2010,78195,19838,30853,28179,2674,22250,5929,68621.77,0.192
30087,2011,79264,19910,30997,28280,2717,21665,6615,65116.15,0.213
30087,2012,79963,19972,31072,28350,2722,21523,6827,64830.62,0.22
30087,2013,80903,20220,31136,28422,2714,21066,7356,65076.92,0.236
30087,2014,80725,20458,31126,28434,2692,20918,7516,63952.15,0.241
30087,2015,82601,21073,31311,28858,2453,21167,7691,65579.46,0.246
30087,2016,83712,21809,31616,29545,2071,21629,7916,67650.69,0.25
30087,2017,85197,22446,32017,30142,1875,21777,8365,70375.08,0.261
30087,2018,85809,23458,31991,30295,1696,21764,8531,73773.38,0.267
30087,2019,87158,24652,31949,30306,1643,21837,8469,79474.08,0.265
30088,2010,75198,13114,29740,26293,3447,18193,8100,51391.33,0.272
30088,2011,75080,13685,29735,25983,3752,17546,8437,52431.08,0.284
30088,2012,75038,13741,29779,25910,3869,17410,8500,51582.58,0.285
30088,2013,74218,13815,29800,25904,3896,17276,8628,50375.17,0.29
30088,2014,74686,13887,29770,26056,3714,16950,9106,49776.67,0.306
30088,2015,75315,14149,29958,26163,3795,16533,9630,48454.92,0.321
30088,2016,76916,14220,29866,26600,3266,16486,10114,47826.58,0.339
30088,2017,78023,14328,30223,27206,3017,16769,10437,49220.58,0.345
30088,2018,80566,15038,30111,27530,2581,16665,10865,50224.92,0.361
30088,2019,80692,15125,30390,27996,2394,16539,11457,50716.83,0.377
30090,2010,12203,1514,4165,3644,521,2146,1498,43724.5,0.36
30090,2011,11763,1669,4013,3476,537,1951,1525,46929.0,0.38
30090,2012,12266,1772,3945,3451,494,2039,1412,44930.5,0.358
30090,2013,11768,1704,3875,3330,545,1947,1383,45404.5,0.357
30090,2014,11834,1648,3878,3342,536,2000,1342,42595.0,0.346
30090,2015,12072,1792,4005,3522,483,2127,1395,46827.5,0.348
30090,2016,12817,1878,4116,3762,354,2235,1527,47205.5,0.371
30090,2017,12955,1858,4084,3805,279,2197,1608,48069.5,0.394
30090,2018,13344,1975,4129,3913,216,2281,1632,52986.0,0.395
30090,2019,13280,2250,4277,4038,239,2391,1647,57279.5,0.385
30091,2010,2741,1189,1194,1116,78,969,147,86645.0,0.123
30091,2011,2590,1135,1113,1040,73,869,171,89125.0,0.154
30091,2012,2245,949,936,873,63,716,157,89620.0,0.168
30091,2013,2620,1085,1003,992,11,838,154,100588.0,0.154
30091,2014,2665,1228,1153,1079,74,905,174,95329.0,0.151
30091,2015,2732,1158,1176,1084,92,893,191,94559.0,0.162
30091,2016,2722,1121,1169,1074,95,864,210,102813.0,0.18
30091,2017,2646,1205,1129,1041,88,839,202,100284.0,0.179
30091,2018,2762,1233,1186,1087,99,897,190,103631.0,0.16
30091,2019,2830,1214,1135,1080,55,891,189,104302.0,0.167
30092,2010,52147,17144,21733,19971,1762,12368,7603,83853.0,0.35
30092,2011,51614,17208,21373,19517,1856,12138,7379,88409.33,0.345
30092,2012,52317,17139,21204,19324,1880,11653,7671,84020.58,0.362
30092,2013,53929,17587,21354,19569,1785,11792,7777,82404.67,0.364
30092,2014,54836,18226,21318,19739,1579,11632,8107,81554.42,0.38
30092,2015,55239,18966,22209,20435,1774,11862,8573,81918.08,0.386
30092,2016,56126,19358,22650,20922,1728,12025,8897,84030.17,0.393
30092,2017,56444,19637,22910,21153,1757,12318,8835,87184.83,0.386
30092,2018,56377,19854,23216,21850,1366,12362,9488,88619.67,0.409
30092,2019,57031,20146,23538,22234,1304,12450,9784,90889.0,0.416
30093,2010,80320,11222,31463,27329,4134,11866,15463,41871.85,0.491
30093,2011,84507,10890,32212,27700,4512,11378,16322,40224.46,0.507
30093,2012,88781,10857,32748,28675,4073,11327,17348,39608.0,0.53
30093,2013,90521,10178,32866,28644,4222,11051,17593,38912.31,0.535
30093,2014,91989,10743,32953,29289,3664,11221,18068,39771.69,0.548
30093,2015,92386,11393,32759,29472,3287,11464,18008,40774.23,0.55
30093,2016,92045,11703,32815,29900,2915,11574,18326,41749.69,0.558
30093,2017,93702,11988,33025,30074,2951,11464,18610,42965.15,0.564
30093,2018,92602,12307,32615,30172,2443,11458,18714,44733.77,0.574
30093,2019,93045,12752,32869,30528,2341,11007,19521,47019.62,0.594
30094,2010,63870,10930,25178,22120,3058,16990,5130,59198.7,0.204
30094,2011,64558,11666,26080,22850,3230,17404,5446,58699.1,0.209
30094,2012,66630,11804,26516,23262,3254,17778,5484,56812.4,0.207
30094,2013,67400,13212,26860,23712,3148,17821,5891,55802.1,0.219
30094,2014,68698,13212,26992,24145,2847,17822,6323,55253.9,0.234
30094,2015,71206,14130,26979,24478,2501,17512,6966,53769.5,0.258
30094,2016,72856,14148,27088,24827,2261,16996,7831,54907.8,0.289
30094,2017,71271,13582,26478,24209,2269,16567,7642,57753.1,0.289
30094,2018,70844,12932,26778,24564,2214,16541,8023,59369.0,0.3
30094,2019,69343,12613,27043,24871,2172,16824,8047,61620.2,0.298
30095,2010,6231,880,2895,2469,426,521,1948,30744.0,0.673
30095,2011,5564,608,2404,2088,316,365,1723,27045.0,0.717
30095,2012,5176,562,2300,1978,322,356,1622,29242.0,0.705
30095,2013,5087,501,2252,1991,261,361,1630,30067.0,0.724
30095,2014,5395,510,2177,1920,257,398,1522,29583.0,0.699
30095,2015,5252,684,2120,1883,237,451,1432,31126.0,0.675
30095,2016,5491,727,2107,1889,218,484,1405,31758.0,0.667
30095,2017,5411,817,2177,1988,189,497,1491,33284.0,0.685
30095,2018,5446,795,2171,1966,205,431,1535,36482.0,0.707
30095,2019,5623,916,2166,1989,177,403,1586,44870.0,0.732
30096,2010,108555,25217,45410,40431,4979,20666,19765,53802.17,0.435
30096,2011,110437,25432,45583,40279,5304,20217,20062,52609.5,0.44
30096,2012,111975,25969,45518,40449,5069,19983,20466,52806.06,0.45
30096,2013,114629,25711,45391,40860,4531,19404,21456,52058.11,0.473
30096,2014,118354,26083,45266,41559,3707,19358,22201,51523.44,0.49
30096,2015,120191,27504,45624,42419,3205,19248,23171,50742.33,0.508
30096,2016,122707,28556,46279,43134,3145,19850,23284,53216.61,0.503
30096,2017,123584,29267,46613,43466,3147,20126,23340,54346.33,0.501
30096,2018,121558,29360,46674,43484,3190,20051,23433,56704.33,0.502
30096,2019,122090,31433,46944,43859,3085,20035,23824,61327.28,0.507
30097,2010,109403,40593,39941,37744,2197,28656,9088,98345.88,0.228
30097,2011,111666,41479,40770,38126,2644,28680,9446,99882.75,0.232
30097,2012,116246,42948,41578,38839,2739,28569,10270,98545.69,0.247
30097,2013,117816,43526,41477,38895,2582,28172,10723,96187.5,0.259
30097,2014,120116,44806,41943,39573,2370,28693,10880,93731.44,0.259
30097,2015,122637,45799,42563,40013,2550,28667,11346,94079.0,0.267
30097,2016,125859,48282,43660,41541,2119,30224,11317,94579.81,0.259
30097,2017,126093,49237,44374,42137,2237,30924,11213,98495.88,0.253
30097,2018,127718,51260,45213,42992,2221,31259,11733,103924.38,0.26
30097,2019,129411,53834,46325,43760,2565,31806,11954,112025.38,0.258
30098,2010,9381,3692,2747,2686,61,2510,176,119167.0,0.064
30098,2011,9496,3998,2854,2810,44,2630,180,121968.0,0.063
30098,2012,10003,4328,3056,2975,81,2826,149,125540.0,0.049
30098,2013,9752,4167,2947,2872,75,2739,133,130294.0,0.045
30098,2014,9940,4508,2989,2943,46,2899,44,138969.0,0.015
30098,2015,10014,4642,2939,2893,46,2823,70,138656.0,0.024
30098,2016,10449,4665,3082,3038,44,2763,275,137344.0,0.089
30098,2017,10206,4903,3176,3092,84,2717,375,137643.0,0.118
30098,2018,10525,5140,3319,3176,143,2765,411,142917.0,0.124
30098,2019,11005,5405,3633,3379,254,2846,533,149583.0,0.147
30099,2010,8779,3071,3563,3240,323,1958,1282,81368.0,0.36
30099,2011,8770,2912,3698,3241,457,1776,1465,78005.0,0.396
30099,2012,8913,3064,3771,3328,443,1837,1491,78873.0,0.395
30099,2013,9223,3416,3828,3498,330,1898,1600,71127.0,0.418
30099,2014,10119,3683,3869,3658,211,2046,1612,64356.0,0.417
30099,2015,10161,3646,3967,3714,253,2134,1580,60957.0,0.398
30099,2016,10552,3965,4112,3774,338,2361,1413,72949.0,0.344
30099,2017,10808,3905,4178,3796,382,2262,1534,75274.0,0.367
30099,2018,10131,3652,4004,3602,402,2237,1365,73571.0,0.341
30099,2019,9388,3850,4075,3519,556,2259,1260,91451.0,0.309
30101,2010,118876,27444,43981,40281,3700,34758,5523,75160.17,0.126
30101,2011,121628,26539,45548,41386,4162,35448,5938,75786.83,0.13
30101,2012,125205,27601,46361,42232,4129,36163,6069,75805.33,0.131
30101,2013,126576,28039,46851,42856,3995,35863,6993,74498.0,0.149
30101,2014,129272,29231,47531,43963,3568,35665,8298,75347.83,0.175
30101,2015,130701,30567,47823,44486,3337,35657,8829,75246.06,0.185
30101,2016,132811,33630,48059,45053,3006,35840,9213,77840.61,0.192
30101,2017,136509,34950,48915,46440,2475,36725,9715,80480.83,0.199
30101,2018,138807,36770,49800,47457,2343,37223,10234,82478.67,0.206
30101,2019,141486,37520,50279,47994,2285,38127,9867,87250.5,0.196
30102,2010,64355,11868,24619,22698,1921,17378,5320,61844.0,0.216
30102,2011,63226,12246,24963,22652,2311,17244,5408,62358.73,0.217
30102,2012,64472,12410,25063,22679,2384,17150,5529,63564.0,0.221
30102,2013,65170,12320,25442,22897,2545,17129,5768,59015.45,0.227
30102,2014,66348,12475,25744,23386,2358,17217,6169,59094.0,0.24
30102,2015,67665,12496,25823,23715,2108,17246,6469,59251.27,0.251
30102,2016,67930,13079,25957,23990,1967,17128,6862,61991.82,0.264
30102,2017,70591,14268,26350,24776,1574,17643,7133,64295.0,0.271
30102,2018,72385,15774,26694,25394,1300,18030,7364,69141.64,0.276
30102,2019,72769,16375,26717,25325,1392,18346,6979,72917.55,0.261
30103,2010,47745,6113,19033,16697,2336,13352,3345,58070.43,0.176
30103,2011,47995,6274,18895,16363,2532,12756,3607,62658.14,0.191
30103,2012,48676,6314,19308,16601,2707,12852,3749,64312.57,0.194
30103,2013,48055,6282,19309,16861,2448,13153,3708,62814.14,0.192
30103,2014,47014,6268,18937,16541,2396,12642,3899,63766.43,0.206
30103,2015,45953,6611,18958,16568,2390,12221,4347,63117.57,0.229
30103,2016,46590,6558,18972,16932,2040,12160,4772,62503.0,0.252
30103,2017,46431,6796,19104,17154,1950,12784,4370,65188.57,0.229
30103,2018,46594,6888,19117,16935,2182,12470,4465,68232.43,0.234
30103,2019,46986,7041,19362,17182,2180,12766,4416,70868.86,0.228
30104,2010,24257,2169,8936,7895,1041,6536,1359,49962.4,0.152
30104,2011,24675,2539,9231,8218,1013,6780,1438,51281.4,0.156
30104,2012,24352,2616,9211,8265,946,6903,1362,50376.2,0.148
30104,2013,23684,2514,9240,8341,899,6848,1493,48970.4,0.162
30104,2014,23582,2586,9407,8486,921,7002,1484,49716.8,0.158
30104,2015,23244,2526,9345,8375,970,6843,1532,49864.0,0.164
30104,2016,22920,2227,9335,8375,960,6807,1568,46592.6,0.168
30104,2017,23650,2318,9547,8604,943,6890,1714,51775.6,0.18
30104,2018,24728,2535,9718,8715,1003,7095,1620,56124.2,0.167
30104,2019,24565,2692,9646,8642,1004,7121,1521,60971.8,0.158
30105,2010,15817,1526,6075,5368,707,4202,1166,46667.0,0.192
30105,2011,15993,1919,6289,5573,716,4363,1210,47577.75,0.192
30105,2012,15723,1794,6323,5565,758,4397,1168,45782.75,0.185
30105,2013,15715,1779,6397,5744,653,4529,1215,45100.5,0.19
30105,2014,15800,1733,6360,5754,606,4524,1230,44910.0,0.193
30105,2015,15567,1662,6328,5708,620,4523,1185,45964.5,0.187
30105,2016,15624,1347,6312,5700,612,4518,1182,43475.0,0.187
30105,2017,15876,1453,6365,5796,569,4512,1284,49000.25,0.202
30105,2018,16585,1538,6529,5914,615,4662,1252,53260.75,0.192
30105,2019,16335,1702,6496,5822,674,4678,1144,58714.75,0.176
30106,2010,55600,9052,23703,21090,2613,13022,8068,48533.44,0.34
30106,2011,57007,9151,23866,21382,2484,12843,8539,48399.67,0.358
30106,2012,57890,9744,24074,21617,2457,12771,8846,49752.78,0.367
30106,2013,57973,9402,24381,21737,2644,12547,9190,47534.0,0.377
30106,2014,58893,9898,24396,22039,2357,12312,9727,49697.0,0.399
30106,2015,59855,9909,24314,22220,2094,11769,10451,49839.33,0.43
30106,2016,59540,10630,24503,22445,2058,11844,10601,51087.67,0.433
30106,2017,61772,10584,24838,22748,2090,12106,10642,51522.44,0.428
30106,2018,63578,11534,25000,23173,1827,12086,11087,56150.0,0.443
30106,2019,65279,12266,25414,23771,1643,12613,11158,60083.78,0.439
30107,2010,41958,6184,17688,15696,1992,11976,3720,57243.0,0.21
30107,2011,42457,6206,17990,15802,2188,12093,3709,57392.71,0.206
30107,2012,44527,6201,18397,16426,1971,12477,3949,58976.71,0.215
30107,2013,45395,6253,18675,16368,2307,12364,4004,58047.43,0.214
30107,2014,47430,7075,19094,16995,2099,12675,4320,57789.57,0.226
30107,2015,48064,7005,18894,16982,1912,12423,4559,59859.86,0.241
30107,2016,49582,7608,18775,16994,1781,12384,4610,63489.43,0.246
30107,2017,49248,7786,18864,17086,1778,12709,4377,66281.71,0.232
30107,2018,50349,8444,19072,17772,1300,13251,4521,70050.29,0.237
30107,2019,50824,8725,19447,18190,1257,13696,4494,74858.86,0.231
30108,2010,30523,2792,12678,11058,1620,8124,2934,43458.5,0.231
30108,2011,30558,2911,12861,11298,1563,8321,2977,41449.33,0.231
30108,2012,31117,2866,12811,11306,1505,8265,3041,42028.5,0.237
30108,2013,30441,2914,12544,10961,1583,8125,2836,42804.83,0.226
30108,2014,30562,3132,12474,10948,1526,8029,2919,43790.67,0.234
30108,2015,30004,3136,12375,10926,1449,7714,3212,41570.17,0.26
30108,2016,30278,3238,12442,10955,1487,7813,3142,46181.67,0.253
30108,2017,31463,3320,12761,11210,1551,8071,3139,46576.5,0.246
30108,2018,31563,3283,12840,11309,1531,8310,2999,47436.5,0.234
30108,2019,32024,3404,13002,11654,1348,8799,2855,50054.5,0.22
30109,2010,6485,801,2463,2276,187,1677,599,45656.0,0.243
30109,2011,6243,713,2492,2237,255,1615,622,43014.0,0.25
30109,2012,6293,629,2416,2211,205,1564,647,44565.0,0.268
30109,2013,6559,629,2380,2186,194,1548,638,42287.0,0.268
30109,2014,6225,679,2421,2133,288,1427,706,42236.0,0.292
30109,2015,5869,589,2411,2111,300,1428,683,38373.0,0.283
30109,2016,5978,531,2436,2164,272,1450,714,45111.0,0.293
30109,2017,6467,595,2670,2337,333,1659,678,45372.0,0.254
30109,2018,6681,640,2716,2379,337,1841,538,49940.0,0.198
30109,2019,6751,603,2748,2470,278,1901,569,48596.0,0.207
30110,2010,79518,9455,32519,28704,3815,22380,6324,48635.23,0.194
30110,2011,81281,10093,33060,29216,3844,22563,6653,49040.69,0.201
30110,2012,83100,10344,33749,29763,3986,22791,6972,47822.46,0.207
30110,2013,83133,10226,33940,29930,4010,22588,7342,46738.77,0.216
30110,2014,82067,10265,33693,29533,4160,21865,7668,46699.92,0.228
30110,2015,83428,10817,33837,29687,4150,21800,7887,46171.15,0.233
30110,2016,83988,11444,33658,29590,4068,21534,8056,47101.08,0.239
30110,2017,85561,11884,34081,30066,4015,21668,8398,50766.54,0.246
30110,2018,88331,12874,34442,30805,3637,22775,8030,54540.54,0.233
30110,2019,91614,14091,35374,32257,3117,23524,8733,57880.69,0.247
30111,2010,5573,912,2177,2061,116,1613,448,49003.0,0.206
30111,2011,5430,930,2172,1981,191,1512,469,52401.0,0.216
30111,2012,5079,798,2208,1944,264,1488,456,50570.0,0.207
30111,2013,5122,729,2232,1903,329,1443,460,46234.0,0.206
30111,2014,5169,703,2190,1876,314,1385,491,44202.0,0.224
30111,2015,4980,716,2166,1874,292,1261,613,47672.0,0.283
30111,2016,5083,870,2133,1923,210,1356,567,45292.0,0.266
30111,2017,5800,948,2245,2088,157,1470,618,42265.0,0.275
30111,2018,5901,1110,2304,2139,165,1560,579,52019.0,0.251
30111,2019,6166,1226,2461,2313,148,1670,643,58739.0,0.261
30112,2010,9304,1276,3537,3065,472,1981,1084,44894.0,0.306
30112,2011,9159,1226,3489,3023,466,1834,1189,44428.0,0.341
30112,2012,9499,1435,3502,3070,432,1944,1126,46250.0,0.322
30112,2013,9194,1226,3430,3065,365,1743,1322,44002.0,0.385
30112,2014,8897,1419,3346,3023,323,1764,1259,43644.0,0.376
30112,2015,8651,1274,3335,2982,353,1708,1274,44295.0,0.382
30112,2016,9360,1409,3390,3180,210,1976,1204,44270.0,0.355
30112,2017,9278,1455,3442,3225,217,2045,1180,43761.0,0.343
30112,2018,9166,1592,3483,3217,266,2113,1104,46937.0,0.317
30112,2019,9664,1600,3516,3328,188,2173,1155,52351.0,0.328
30113,2010,76406,8911,31817,27709,4108,21351,6358,48097.93,0.2
30113,2011,78440,9623,32466,28274,4192,21694,6580,48662.13,0.203
30113,2012,80065,10180,33292,29030,4262,22225,6805,48440.0,0.204
30113,2013,80880,10417,33502,29203,4299,22128,7075,47654.93,0.211
30113,2014,80607,10547,33275,28852,4423,21885,6967,47986.2,0.209
30113,2015,81695,10925,33484,29035,4449,21920,7115,48007.87,0.212
30113,2016,82615,11662,33317,29161,4156,21723,7438,48847.93,0.223
30113,2017,83233,11758,33561,29317,4244,21307,8010,52238.07,0.239
30113,2018,84535,12571,33745,29768,3977,22061,7707,55394.93,0.228
30113,2019,87827,13754,34839,31297,3542,22613,8684,58315.33,0.249
30114,2010,74218,13758,29744,26996,2748,20728,6268,58752.12,0.211
30114,2011,76518,13621,30184,27479,2705,20751,6728,58221.25,0.223
30114,2012,78525,13993,30643,27691,2952,21046,6645,59210.12,0.217
30114,2013,78750,13891,30704,27453,3251,20418,7035,57720.25,0.229
30114,2014,81037,15035,30870,28131,2739,20591,7540,59454.5,0.244
30114,2015,81736,15274,30930,28574,2356,20673,7901,58256.62,0.255
30114,2016,83267,15914,31050,28796,2254,20752,8044,62125.62,0.259
30114,2017,84391,16332,31204,29327,1877,20847,8480,63242.25,0.272
30114,2018,85597,17250,31709,30201,1508,21659,8542,69516.12,0.269
30114,2019,87658,18257,32675,31225,1450,21823,9402,72711.62,0.288
30115,2010,83461,18479,30896,29097,1799,24599,4498,73513.0,0.146
30115,2011,86234,18977,31218,29664,1554,25013,4651,72092.11,0.149
30115,2012,86372,19944,31535,29441,2094,25060,4381,74226.0,0.139
30115,2013,87568,19970,31574,29249,2325,24725,4524,73086.33,0.143
30115,2014,88195,19756,31915,29699,2216,24653,5046,71736.11,0.158
30115,2015,89346,20944,32480,30562,1918,25052,5510,71116.67,0.17
30115,2016,90742,21378,32884,30819,2065,24994,5825,76989.0,0.177
30115,2017,93638,21821,33219,31715,1504,25197,6518,79319.67,0.196
30115,2018,96046,23449,33747,32577,1170,26084,6493,82544.0,0.192
30115,2019,99466,25100,34520,33373,1147,26596,6777,89697.0,0.196
30116,2010,60155,7314,24561,21896,2665,16199,5697,49316.67,0.232
30116,2011,61625,7439,24801,22038,2763,15969,6069,50388.33,0.245
30116,2012,61731,7815,24906,21958,2948,16132,5826,50486.44,0.234
30116,2013,61487,7587,24941,22068,2873,15901,6167,50523.56,0.247
30116,2014,61687,7794,24660,21982,2678,15234,6748,49047.44,0.274
30116,2015,62435,7620,24457,21951,2506,14931,7020,48472.89,0.287
30116,2016,63374,8023,24786,22498,2288,15943,6555,50874.89,0.264
30116,2017,63319,8769,24969,23045,1924,16301,6744,51902.11,0.27
30116,2018,65192,9375,25047,23404,1643,17040,6364,56412.33,0.254
30116,2019,65612,10080,25233,23812,1421,17833,5979,60794.33,0.237
30117,2010,79050,9055,31834,28544,3290,18535,10009,41283.08,0.314
30117,2011,80041,9202,31869,28572,3297,18762,9810,41786.92,0.308
30117,2012,80164,9176,31882,28249,3633,18391,9858,41909.42,0.309
30117,2013,79461,8847,31532,28006,3526,17943,10063,41280.58,0.319
30117,2014,79391,8954,31447,27950,3497,17139,10811,41730.42,0.344
30117,2015,80492,8891,31672,28471,3201,16728,11743,40592.08,0.371
30117,2016,80400,9188,31463,28301,3162,16940,11361,43749.67,0.361
30117,2017,81191,10031,31990,29092,2898,17705,11387,43891.25,0.356
30117,2018,82173,10581,32054,29175,2879,18305,10870,47364.92,0.339
30117,2019,83359,11421,32115,29675,2440,19278,10397,50415.0,0.324
30118,2010,7686,391,2433,2232,201,863,1369,35810.0,0.563
30118,2011,7856,422,2405,2084,321,831,1253,35000.0,0.521
30118,2012,8069,431,2525,2137,388,832,1305,36720.0,0.517
30118,2013,8572,492,2586,2178,408,751,1427,30625.0,0.552
30118,2014,8799,591,2665,2210,455,708,1502,33324.0,0.564
30118,2015,9006,612,2789,2383,406,747,1636,33213.0,0.587
30118,2016,8615,644,2679,2308,371,690,1618,35267.0,0.604
30118,2017,8677,667,2782,2312,470,746,1566,35381.0,0.563
30118,2018,8648,761,2637,2176,461,624,1552,38370.0,0.589
30118,2019,8778,736,2660,2232,428,754,1478,38916.0,0.556
30119,2010,6436,964,2687,2537,150,1413,1124,40994.0,0.418
30119,2011,6768,1066,2677,2501,176,1447,1054,44873.0,0.394
30119,2012,6276,1155,2608,2307,301,1494,813,43021.0,0.312
30119,2013,6178,1134,2638,2266,372,1477,789,45026.0,0.299
30119,2014,6124,1182,2638,2298,340,1428,870,43248.0,0.33
30119,2015,6157,936,2678,2306,372,1330,976,43231.0,0.364
30119,2016,6083,819,2631,2212,419,1260,952,47575.0,0.362
30119,2017,6127,880,2544,2239,305,1321,918,52017.0,0.361
30119,2018,6595,828,2521,2340,181,1495,845,61341.0,0.335
30119,2019,6564,957,2528,2307,221,1491,816,68179.0,0.323
30120,2010,102714,12171,40383,35724,4659,26744,8980,53854.07,0.222
30120,2011,104597,12211,41203,36162,5041,26232,9930,53610.29,0.241
30120,2012,106784,12882,41623,36657,4966,26130,10527,54127.36,0.253
30120,2013,107025,13021,41706,36640,5066,25684,10956,52939.5,0.263
30120,2014,107247,14192,41842,37302,4540,25787,11515,54312.21,0.275
30120,2015,107817,15077,41742,37696,4046,25378,12318,55190.57,0.295
30120,2016,109656,16595,42140,38765,3375,25958,12807,56720.57,0.304
30120,2017,110706,16817,42618,39358,3260,26581,12777,58733.64,0.3
30120,2018,112363,16592,43129,39757,3372,27163,12594,61530.64,0.292
30120,2019,115051,16366,43680,40335,3345,27706,12629,63559.57,0.289
30121,2010,49123,4877,19988,17791,2197,11838,5953,45765.0,0.298
30121,2011,50208,5224,20331,17733,2598,11381,6352,47352.83,0.312
30121,2012,50844,4998,20660,17905,2755,11317,6588,48697.0,0.319
30121,2013,51216,4898,20711,17897,2814,11250,6647,46620.33,0.321
30121,2014,51546,5147,20530,18051,2479,11118,6933,47583.0,0.338
30121,2015,52202,5380,20483,18187,2296,10725,7462,48658.83,0.364
30121,2016,53290,5884,20719,18956,1763,11069,7887,50839.83,0.381
30121,2017,52971,6357,20827,19289,1538,11511,7778,50430.5,0.373
30121,2018,53670,6237,21064,19368,1696,11580,7788,52934.0,0.37
30121,2019,54442,6429,21535,19713,1822,11922,7791,55035.67,0.362
30122,2010,47234,6313,18883,16736,2147,9810,6926,48157.0,0.367
30122,2011,48451,6750,19285,17182,2103,9789,7393,46469.14,0.383
30122,2012,49880,6950,19696,17713,1983,9759,7954,45785.14,0.404
30122,2013,50232,6765,19919,17750,2169,9478,8272,43461.86,0.415
30122,2014,48812,6792,19824,17845,1979,9214,8631,44459.29,0.435
30122,2015,49276,7163,19785,18030,1755,9126,8904,44328.71,0.45
30122,2016,50136,7426,19957,18220,1737,9138,9082,47942.14,0.455
30122,2017,50478,7409,19812,18078,1734,9055,9023,49747.86,0.455
30122,2018,51605,7933,19897,18441,1456,8752,9689,52986.57,0.487
30122,2019,53620,8816,20099,18716,1383,9046,9670,57456.57,0.481
30123,2010,7541,782,2651,2267,384,1966,301,55033.0,0.114
30123,2011,7784,696,2557,2254,303,1958,296,58097.0,0.116
30123,2012,7803,814,2609,2281,328,1913,368,59327.0,0.141
30123,2013,7310,797,2604,2278,326,1977,301,58203.0,0.116
30123,2014,6926,697,2491,2235,256,1817,418,52120.0,0.168
30123,2015,6640,813,2486,2263,223,1754,509,60430.0,0.205
30123,2016,6714,685,2538,2284,254,1742,542,60550.0,0.214
30123,2017,7167,587,2643,2369,274,1917,452,59639.0,0.171
30123,2018,6393,462,2500,2157,343,1744,413,63701.0,0.165
30123,2019,6452,494,2539,2213,326,1847,366,65576.0,0.144
30124,2010,26520,3069,10811,9427,1384,7070,2357,45208.17,0.218
30124,2011,26926,3239,11109,9550,1559,7282,2268,48044.17,0.204
30124,2012,27330,3244,11237,9938,1299,7504,2434,49162.67,0.217
30124,2013,27267,3342,11025,9723,1302,7406,2317,50004.0,0.21
30124,2014,27652,3374,11127,9576,1551,7477,2099,49418.67,0.189
30124,2015,27240,3164,11167,9563,1604,7508,2055,51117.17,0.184
30124,2016,27320,3154,11109,9717,1392,7484,2233,51521.33,0.201
30124,2017,27109,3276,11326,9670,1656,7358,2312,53845.0,0.204
30124,2018,27184,3075,11269,9721,1548,7389,2332,56194.0,0.207
30124,2019,26899,3242,11258,9818,1440,7363,2455,60024.17,0.218
30125,2010,72730,8088,30760,26413,4347,20046,6367,45343.38,0.207
30125,2011,73730,8594,31156,26579,4577,20497,6082,47204.06,0.195
30125,2012,75207,8581,31787,27316,4471,20962,6354,47304.12,0.2
30125,2013,75348,8657,31524,27134,4390,20842,6292,47545.5,0.2
30125,2014,75094,8650,31475,26723,4752,20641,6082,48008.62,0.193
30125,2015,75264,8360,31591,26885,4706,20541,6344,48970.38,0.201
30125,2016,75436,8193,31358,27092,4266,20443,6649,49015.19,0.212
30125,2017,75109,8582,31521,27117,4404,20240,6877,52034.0,0.218
30125,2018,75903,8585,31977,27512,4465,20493,7019,54761.81,0.22
30125,2019,76685,9257,32407,28278,4129,21077,7201,59267.88,0.222
30126,2010,66188,17809,28589,25948,2641,19053,6895,62055.5,0.241
30126,2011,68201,18560,28786,26173,2613,19238,6935,62233.7,0.241
30126,2012,68297,19136,28861,26086,2775,19017,7069,62837.1,0.245
30126,2013,70816,18914,29120,26258,2862,18990,7268,63150.2,0.25
30126,2014,72965,18781,29634,26960,2674,18977,7983,62544.4,0.269
30126,2015,73221,18780,29600,26904,2696,18643,8261,63026.0,0.279
30126,2016,72908,18699,29464,26760,2704,18511,8249,64595.8,0.28
30126,2017,74582,18850,30024,27492,2532,18691,8801,67438.3,0.293
30126,2018,75771,19925,30015,27640,2375,18528,9112,71766.3,0.304
30126,2019,75723,21188,30037,27653,2384,18714,8939,76054.0,0.298
30127,2010,127876,25980,47063,43527,3536,37315,6212,73237.0,0.132
30127,2011,126906,25969,46891,43414,3477,36860,6554,73662.81,0.14
30127,2012,127897,26382,47136,43329,3807,36692,6637,73020.48,0.141
30127,2013,128814,27719,46697,42946,3751,36170,6776,72454.57,0.145
30127,2014,129358,28865,46859,43652,3207,36031,7621,75236.19,0.163
30127,2015,131681,29028,47161,44524,2637,36406,8118,73275.38,0.172
30127,2016,133143,30618,47382,44747,2635,36556,8191,75349.81,0.173
30127,2017,137750,32427,48396,46110,2286,37467,8643,77831.62,0.179
30127,2018,138435,33561,49130,46773,2357,37861,8912,80213.67,0.181
30127,2019,140279,33605,49531,47012,2519,38164,8848,83822.81,0.179
30129,2010,2441,1456,1759,1497,262,540,957,69473.0,0.544
30129,2011,2444,1485,1664,1494,170,551,943,70260.0,0.567
30129,2012,2177,1326,1591,1397,194,541,856,68169.0,0.538
30129,2013,2080,1216,1522,1356,166,541,815,69018.0,0.535
30129,2014,2157,1321,1495,1353,142,559,794,70215.0,0.531
30129,2015,2237,1423,1485,1361,124,535,826,71469.0,0.556
30129,2016,2219,1440,1514,1375,139,600,775,77238.0,0.512
30129,2017,2281,1461,1458,1300,158,589,711,86333.0,0.488
30129,2018,2514,1704,1566,1419,147,582,837,80168.0,0.534
30129,2019,2345,1769,1525,1408,117,565,843,84167.0,0.553
30132,2010,92996,12598,35210,32098,3112,25888,6210,61837.25,0.176
30132,2011,98436,13896,36629,33714,2915,27062,6652,62595.17,0.182
30132,2012,103155,15478,37416,34407,3009,27792,6615,63906.25,0.177
30132,2013,104174,15752,38002,34561,3441,27858,6703,62960.42,0.176
30132,2014,106358,16453,38380,35371,3009,27778,7593,63821.42,0.198
30132,2015,107652,17000,38729,35857,2872,27821,8036,62648.17,0.207
30132,2016,108654,17817,38903,36353,2550,28358,7995,63163.33,0.206
30132,2017,110306,17564,39981,37514,2467,28725,8789,65188.75,0.22
30132,2018,113706,17954,40948,38691,2257,28894,9797,66934.67,0.239
30132,2019,117206,16765,41893,39335,2558,29334,10001,68540.0,0.239
30133,2010,4893,1026,2549,2230,319,856,1374,35517.0,0.539
30133,2011,5367,948,2503,2161,342,842,1319,41680.0,0.527
30133,2012,5238,1028,2409,1983,426,875,1108,41615.0,0.46
30133,2013,5299,759,2425,2060,365,868,1192,42972.0,0.492
30133,2014,5375,782,2409,1973,436,861,1112,45229.0,0.462
30133,2015,5337,834,2465,2005,460,703,1302,38098.0,0.528
30133,2016,5238,867,2278,1947,331,587,1360,31841.0,0.597
30133,2017,5769,982,2460,2163,297,703,1460,36651.0,0.593
30133,2018,5593,1017,2398,2176,222,583,1593,41781.0,0.664
30133,2019,5463,835,2415,2205,210,593,1612,39140.0,0.667
30134,2010,100578,12934,37871,34380,3491,26069,8311,56496.33,0.219
30134,2011,103179,14030,38654,34900,3754,26827,8073,58027.13,0.209
30134,2012,101733,13935,38467,34475,3992,26546,7929,56220.67,0.206
30134,2013,102945,13815,38078,34438,3640,26586,7852,56008.73,0.206
30134,2014,103769,13496,38438,34734,3704,26308,8426,55120.53,0.219
30134,2015,104403,13971,38298,34906,3392,26226,8680,53937.8,0.227
30134,2016,104391,14235,37799,34935,2864,25481,9454,56064.6,0.25
30134,2017,106141,15143,38386,35939,2447,25853,10086,58373.53,0.263
30134,2018,105948,15542,38192,35590,2602,25314,10276,61987.0,0.269
30134,2019,105813,16185,38186,35658,2528,25188,10470,64507.6,0.274
30135,2010,79704,12129,30252,27040,3212,21558,5482,63292.77,0.181
30135,2011,80573,12345,30522,27243,3279,21531,5712,62285.69,0.187
30135,2012,80192,12811,30750,27620,3130,21340,6280,60680.85,0.204
30135,2013,82743,13182,30915,28010,2905,21387,6623,59803.31,0.214
30135,2014,84651,13628,30925,28264,2661,21469,6795,59994.69,0.22
30135,2015,85185,15011,31053,28366,2687,21045,7321,59371.31,0.236
30135,2016,87649,15614,31503,28742,2761,21201,7541,62823.46,0.239
30135,2017,88869,16479,31555,29241,2314,21804,7437,66058.38,0.236
30135,2018,89048,16451,31823,29507,2316,21997,7510,67992.0,0.236
30135,2019,90501,17344,32186,30129,2057,22350,7779,70642.23,0.242
30137,2010,5200,498,2041,1842,199,1205,637,52790.0,0.312
30137,2011,5018,619,2075,1841,234,1247,594,54482.0,0.286
30137,2012,5379,692,2171,1929,242,1327,602,54051.0,0.277
30137,2013,5676,685,2328,2012,316,1377,635,48558.0,0.273
30137,2014,5589,729,2269,1975,294,1334,641,46802.0,0.283
30137,2015,5722,702,2177,1954,223,1325,629,46786.0,0.289
30137,2016,5417,616,2102,1883,219,1274,609,47483.0,0.29
30137,2017,5404,723,2090,1880,210,1311,569,47424.0,0.272
30137,2018,5598,834,2117,1941,176,1359,582,52889.0,0.275
30137,2019,5557,877,2150,1982,168,1440,542,53636.0,0.252
30138,2010,12000,1812,4554,4105,449,2960,1145,43127.0,0.251
30138,2011,11701,1948,4654,4066,588,3052,1014,51466.0,0.218
30138,2012,11873,1840,4595,4107,488,3007,1100,50462.0,0.239
30138,2013,11465,1699,4410,3937,473,2859,1078,51787.5,0.244
30138,2014,11465,1677,4451,3880,571,2921,959,49076.5,0.215
30138,2015,10941,1614,4523,3857,666,2943,914,52536.0,0.202
30138,2016,11046,1495,4460,3915,545,2862,1053,49611.5,0.236
30138,2017,11350,1671,4626,3964,662,3007,957,52335.5,0.207
30138,2018,11443,1514,4655,3993,662,2995,998,57056.5,0.214
30138,2019,11210,1465,4529,3935,594,2890,1045,65243.5,0.231
30139,2010,22281,1975,10154,8383,1771,6335,2048,44999.4,0.202
30139,2011,23387,2584,10429,8526,1903,6647,1879,50007.4,0.18
30139,2012,23499,2909,10521,8696,1825,6795,1901,52327.8,0.181
30139,2013,24644,3185,10674,8974,1700,7039,1935,51939.0,0.181
30139,2014,24686,3380,10935,9044,1891,7090,1954,53435.8,0.179
30139,2015,25065,3518,11142,9250,1892,7238,2012,49148.2,0.181
30139,2016,24668,3675,10941,9257,1684,7122,2135,48324.0,0.195
30139,2017,24880,3998,11105,9309,1796,7053,2256,52365.4,0.203
30139,2018,24390,3815,11146,9268,1878,7046,2222,57241.4,0.199
30139,2019,25305,3738,11355,9565,1790,7275,2290,57118.0,0.202
30140,2010,15817,1526,6075,5368,707,4202,1166,46667.0,0.192
30140,2011,15993,1919,6289,5573,716,4363,1210,47577.75,0.192
30140,2012,15723,1794,6323,5565,758,4397,1168,45782.75,0.185
30140,2013,15715,1779,6397,5744,653,4529,1215,45100.5,0.19
30140,2014,15800,1733,6360,5754,606,4524,1230,44910.0,0.193
30140,2015,15567,1662,6328,5708,620,4523,1185,45964.5,0.187
30140,2016,15624,1347,6312,5700,612,4518,1182,43475.0,0.187
30140,2017,15876,1453,6365,5796,569,4512,1284,49000.25,0.202
30140,2018,16585,1538,6529,5914,615,4662,1252,53260.75,0.192
30140,2019,16335,1702,6496,5822,674,4678,1144,58714.75,0.176
30141,2010,95019,12538,35203,32694,2509,26222,6472,64323.46,0.184
30141,2011,95525,13172,35125,32560,2565,25995,6565,64670.77,0.187
30141,2012,94127,13467,35034,31933,3101,25799,6134,65328.15,0.175
30141,2013,94767,13975,34824,31725,3099,25323,6402,62611.77,0.184
30141,2014,95588,14090,35003,32032,2971,25086,6946,63430.08,0.198
30141,2015,98027,14479,35277,32592,2685,25519,7073,62029.62,0.2
30141,2016,98247,15383,35421,33024,2397,25668,7356,64080.77,0.208
30141,2017,100453,16263,35981,34145,1836,26407,7738,67427.85,0.215
30141,2018,101410,16619,36393,34244,2149,26251,7993,69126.77,0.22
30141,2019,102894,16948,37064,34767,2297,26337,8430,73644.15,0.227
30142,2010,7601,927,2960,2917,43,2034,883,60613.0,0.298
30142,2011,7320,951,2854,2818,36,2050,768,56522.0,0.269
30142,2012,7849,1099,2881,2851,30,2201,650,59536.0,0.226
30142,2013,7764,896,2879,2829,50,2089,740,52406.0,0.257
30142,2014,7503,1009,2805,2788,17,2015,773,54139.0,0.276
30142,2015,7688,1055,2868,2828,40,2088,740,53307.0,0.258
30142,2016,7836,1135,2949,2882,67,2050,832,59110.0,0.282
30142,2017,7191,975,2899,2781,118,1837,944,54780.0,0.326
30142,2018,7605,1438,2994,2809,185,2015,794,67097.0,0.265
30142,2019,7697,1218,2875,2777,98,1986,791,72299.0,0.275
30143,2010,60702,8118,27776,23210,4566,18474,4736,51079.09,0.171
30143,2011,62554,8467,28322,23320,5002,18600,4720,52033.82,0.167
30143,2012,63081,8716,28532,23840,4692,18811,5029,52556.45,0.176
30143,2013,64135,9329,28795,23862,4933,18953,4909,52376.73,0.17
30143,2014,65229,10315,29126,24081,5045,19016,5065,51913.18,0.174
30143,2015,66399,10962,29247,24475,4772,19299,5176,53606.18,0.177
30143,2016,66740,11380,29071,24536,4535,19205,5331,54917.18,0.183
30143,2017,67431,11847,29575,24783,4792,19487,5296,59237.91,0.179
30143,2018,68314,11604,29785,25539,4246,20048,5491,62363.36,0.184
30143,2019,69692,11951,30344,26197,4147,20651,5546,65481.64,0.183
30144,2010,85625,21547,33872,31193,2679,22154,9039,69491.62,0.267
30144,2011,84760,21765,34272,31282,2990,21545,9737,68734.62,0.284
30144,2012,86983,22393,34480,31733,2747,21079,10654,68944.31,0.309
30144,2013,87538,22487,34625,31779,2846,20469,11310,65841.46,0.327
30144,2014,88593,22740,35021,32314,2707,20838,11476,65505.46,0.328
30144,2015,90660,23336,35535,32997,2538,20814,12183,67291.0,0.343
30144,2016,92409,24189,35969,33667,2302,21057,12610,69846.23,0.351
30144,2017,93874,25035,36250,33938,2312,21326,12612,74118.85,0.348
30144,2018,94837,25865,36552,34623,1929,21668,12955,77427.23,0.354
30144,2019,95604,26103,36910,34912,1998,21916,12996,80613.54,0.352
30145,2010,35928,5024,12337,10796,1541,9057,1739,62569.0,0.141
30145,2011,35130,5226,12183,10831,1352,8881,1950,70778.4,0.16
30145,2012,35888,5243,12450,11198,1252,9031,2167,71896.8,0.174
30145,2013,34752,5116,12299,11105,1194,8911,2194,71394.2,0.178
30145,2014,33885,5086,12230,10995,1235,8658,2337,72837.2,0.191
30145,2015,33652,5419,12260,11013,1247,8297,2716,76345.6,0.222
30145,2016,33102,5306,12419,11198,1221,8083,3115,74158.4,0.251
30145,2017,33896,5567,12632,11467,1165,8528,2939,77219.8,0.233
30145,2018,34711,5945,12821,11467,1354,8551,2916,81576.0,0.227
30145,2019,34530,6088,12646,11495,1151,8732,2763,87522.0,0.218
30146,2010,7601,927,2960,2917,43,2034,883,60613.0,0.298
30146,2011,7320,951,2854,2818,36,2050,768,56522.0,0.269
30146,2012,7849,1099,2881,2851,30,2201,650,59536.0,0.226
30146,2013,7764,896,2879,2829,50,2089,740,52406.0,0.257
30146,2014,7503,1009,2805,2788,17,2015,773,54139.0,0.276
30146,2015,7688,1055,2868,2828,40,2088,740,53307.0,0.258
30146,2016,7836,1135,2949,2882,67,2050,832,59110.0,0.282
30146,2017,7191,975,2899,2781,118,1837,944,54780.0,0.326
30146,2018,7605,1438,2994,2809,185,2015,794,67097.0,0.265
30146,2019,7697,1218,2875,2777,98,1986,791,72299.0,0.275
30147,2010,22812,3318,10640,9045,1595,5199,3846,41190.67,0.361
30147,2011,23333,3385,10801,9238,1563,5448,3790,42003.5,0.351
30147,2012,22549,3330,10886,9407,1479,5539,3868,42084.17,0.355
30147,2013,22864,3770,10805,9420,1385,5670,3750,44025.33,0.347
30147,2014,23164,3897,10922,9407,1515,5737,3670,44203.5,0.336
30147,2015,23613,3908,10972,9615,1357,5795,3820,46012.17,0.348
30147,2016,23317,3924,11032,9701,1331,5666,4035,46664.5,0.366
30147,2017,22735,4072,11090,9598,1492,5594,4004,51968.0,0.361
30147,2018,22419,4000,11092,9711,1381,5586,4125,52179.17,0.372
30147,2019,22379,4546,11186,9845,1341,5936,3909,57960.33,0.349
30148,2010,27605,4359,13894,10953,2941,8789,2164,51464.6,0.156
30148,2011,28364,4748,14265,10844,3421,8800,2044,54242.2,0.143
30148,2012,28578,4913,14291,11204,3087,8978,2226,53317.6,0.156
30148,2013,29604,5324,14481,11434,3047,9306,2128,52963.2,0.147
30148,2014,29848,5717,14790,11521,3269,9250,2271,51607.8,0.154
30148,2015,30494,6107,14890,11714,3176,9353,2361,54173.4,0.159
30148,2016,30518,6382,14601,11737,2864,9324,2413,54702.8,0.165
30148,2017,30962,6766,14911,11706,3205,9277,2429,60193.6,0.163
30148,2018,30797,6357,14916,11895,3021,9489,2406,60451.2,0.161
30148,2019,31274,6251,15055,12157,2898,9765,2392,63304.4,0.159
30150,2010,6485,801,2463,2276,187,1677,599,45656.0,0.243
30150,2011,6243,713,2492,2237,255,1615,622,43014.0,0.25
30150,2012,6293,629,2416,2211,205,1564,647,44565.0,0.268
30150,2013,6559,629,2380,2186,194,1548,638,42287.0,0.268
30150,2014,6225,679,2421,2133,288,1427,706,42236.0,0.292
30150,2015,5869,589,2411,2111,300,1428,683,38373.0,0.283
30150,2016,5978,531,2436,2164,272,1450,714,45111.0,0.293
30150,2017,6467,595,2670,2337,333,1659,678,45372.0,0.254
30150,2018,6681,640,2716,2379,337,1841,538,49940.0,0.198
30150,2019,6751,603,2748,2470,278,1901,569,48596.0,0.207
30151,2010,6938,925,2968,2643,325,2305,338,61384.0,0.114
30151,2011,7548,849,3205,2838,367,2373,465,61360.0,0.145
30151,2012,8116,851,3316,2987,329,2404,583,61445.0,0.176
30151,2013,8113,1009,3397,3053,344,2455,598,60407.0,0.176
30151,2014,8540,1229,3499,3164,335,2566,598,61698.0,0.171
30151,2015,8930,1338,3561,3195,366,2578,617,57306.0,0.173
30151,2016,8965,1440,3465,3157,308,2597,560,61004.0,0.162
30151,2017,8874,1584,3574,3248,326,2766,482,65867.0,0.135
30151,2018,9534,1609,3756,3503,253,3051,452,71414.0,0.12
30151,2019,10145,1783,3942,3765,177,3237,528,74284.0,0.134
30152,2010,116892,34026,45246,41621,3625,32407,9214,82512.69,0.204
30152,2011,118228,34194,46154,42597,3557,32647,9950,83493.75,0.216
30152,2012,121260,34614,46428,42908,3520,32454,10454,82766.62,0.225
30152,2013,122840,34961,46884,43631,3253,32564,11067,82346.75,0.236
30152,2014,124208,35225,47065,44300,2765,32382,11918,82851.12,0.253
30152,2015,125690,36784,47555,44717,2838,32358,12359,86185.31,0.26
30152,2016,127020,37970,47727,45081,2646,32630,12451,87498.19,0.261
30152,2017,127312,38589,47689,44780,2909,32314,12466,90155.94,0.261
30152,2018,128266,39850,47902,45179,2723,32614,12565,93716.56,0.262
30152,2019,129096,41505,48409,45663,2746,33369,12294,98244.0,0.254
30153,2010,77656,7933,32367,28070,4297,22097,5973,47452.25,0.185
30153,2011,80523,8877,33317,28994,4323,23074,5920,48417.44,0.178
30153,2012,82932,9005,34203,29659,4544,23547,6112,47932.69,0.179
30153,2013,83836,9023,34330,29977,4353,23672,6305,47577.31,0.184
30153,2014,83828,9191,34092,29902,4190,23493,6409,48211.12,0.188
30153,2015,84261,8849,34127,30021,4106,23297,6724,48924.75,0.197
30153,2016,84695,8569,33896,30062,3834,23048,7014,48219.0,0.207
30153,2017,84766,8945,34068,30345,3723,23025,7320,51632.5,0.215
30153,2018,86518,9410,34864,30911,3953,23174,7737,54918.81,0.222
30153,2019,87097,9436,35331,31297,4034,23512,7785,60057.06,0.22
30154,2010,4039,496,1676,1443,233,977,466,52042.0,0.278
30154,2011,4189,432,1709,1475,234,901,574,57361.0,0.336
30154,2012,4214,443,1724,1481,243,817,664,56048.0,0.385
30154,2013,4859,543,1816,1711,105,907,804,54344.0,0.443
30154,2014,5238,508,1822,1779,43,948,831,52673.0,0.456
30154,2015,4853,506,1749,1689,60,870,819,48958.0,0.468
30154,2016,4753,567,1719,1672,47,878,794,49896.0,0.462
30154,2017,4806,581,1765,1718,47,956,762,43906.0,0.432
30154,2018,4663,651,1779,1705,74,950,755,46115.0,0.424
30154,2019,4588,691,1822,1728,94,964,764,48619.0,0.419
30156,2010,6644,941,2831,2405,426,1616,789,54695.0,0.279
30156,2011,7079,1056,2924,2532,392,1537,995,52825.0,0.34
30156,2012,7748,1183,2923,2536,387,1484,1052,57381.0,0.36
30156,2013,7637,1456,3052,2651,401,1434,1217,58446.0,0.399
30156,2014,7695,1591,3077,2753,324,1492,1261,61403.0,0.41
30156,2015,7881,1628,3196,2885,311,1586,1299,60645.0,0.406
30156,2016,7798,1443,3263,2990,273,1858,1132,61715.0,0.347
30156,2017,7860,1615,3270,3049,221,1862,1187,62581.0,0.363
30156,2018,7989,1553,3298,3029,269,1843,1186,67612.0,0.36
30156,2019,8236,1548,3414,3098,316,1875,1223,65673.0,0.358
30157,2010,108689,16255,40351,37104,3247,30710,6394,65712.47,0.158
30157,2011,113102,17294,41438,38507,2931,31761,6746,66936.33,0.163
30157,2012,116317,18798,42360,39052,3308,32463,6589,67969.33,0.156
30157,2013,118166,19277,42999,39324,3675,32372,6952,66512.53,0.162
30157,2014,120742,20210,43596,40318,3278,32343,7975,68352.73,0.183
30157,2015,122269,20699,43967,40891,3076,32381,8510,66402.8,0.194
30157,2016,123997,21575,44190,41358,2832,32643,8715,67219.27,0.197
30157,2017,125034,20882,44610,42115,2495,32668,9447,70321.93,0.212
30157,2018,127472,21147,45560,43201,2359,32999,10202,71601.27,0.224
30157,2019,130326,19925,46388,43653,2735,33257,10396,73309.33,0.224
30160,2010,3281,640,1323,1155,168,752,403,49911.0,0.305
30160,2011,3906,630,1225,1076,149,753,323,55789.0,0.264
30160,2012,4515,554,1201,1060,141,698,362,53269.0,0.301
30160,2013,4960,602,1185,1054,131,654,400,51905.0,0.338
30160,2014,5225,533,1191,1085,106,654,431,51104.0,0.362
30160,2015,5852,677,1288,1163,125,672,491,51202.0,0.381
30160,2016,5979,737,1415,1263,152,648,615,51004.0,0.435
30160,2017,6314,837,1457,1322,135,629,693,55738.0,0.476
30160,2018,6714,806,1489,1379,110,556,823,65855.0,0.553
30160,2019,6819,876,1467,1353,114,591,762,67768.0,0.519
30161,2010,42587,10876,18759,15779,2980,9195,6584,56551.78,0.351
30161,2011,43309,11584,19276,16392,2884,9455,6937,61701.11,0.36
30161,2012,42863,11582,19337,16632,2705,9278,7354,61297.89,0.38
30161,2013,41502,11629,19425,16713,2712,9185,7528,62205.67,0.388
30161,2014,41446,11811,19861,17093,2768,9362,7731,62785.0,0.389
30161,2015,41456,12345,20104,17415,2689,8961,8454,66348.56,0.421
30161,2016,41588,12837,20314,17444,2870,8779,8665,66087.11,0.427
30161,2017,43231,13969,21125,18022,3103,9563,8459,72618.78,0.4
30161,2018,44373,14813,21712,18348,3364,9589,8759,76202.67,0.403
30161,2019,45503,16148,22331,19146,3185,10138,9008,83053.0,0.403
30162,2010,2953,2001,3087,2344,743,1261,1083,67864.0,0.351
30162,2011,3263,2260,3131,2447,684,1274,1173,65031.0,0.375
30162,2012,3489,2475,3173,2620,553,1370,1250,71719.0,0.394
30162,2013,3487,2399,3272,2569,703,1299,1270,72762.0,0.388
30162,2014,3797,2459,3472,2826,646,1480,1346,71901.0,0.388
30162,2015,4245,2676,3618,3012,606,1354,1658,81655.0,0.458
30162,2016,4287,2890,3655,2956,699,1335,1621,88125.0,0.444
30162,2017,4356,2968,3833,2949,884,1471,1478,99205.0,0.386
30162,2018,4554,3223,4148,3072,1076,1559,1513,106791.0,0.365
30162,2019,5193,3822,4607,3432,1175,1569,1863,109426.0,0.404
30164,2010,4472,2268,2661,2355,306,1157,1198,66392.0,0.45
30164,2011,4235,2208,2671,2312,359,1160,1152,66154.0,0.431
30164,2012,4013,2051,2536,2211,325,1086,1125,59054.0,0.444
30164,2013,4354,1971,2484,2233,251,943,1290,56320.0,0.519
30164,2014,4492,2142,2472,2229,243,899,1330,57625.0,0.538
30164,2015,4529,2169,2500,2219,281,933,1286,58125.0,0.514
30164,2016,4240,2068,2457,2173,284,826,1347,59756.0,0.548
30164,2017,4655,2265,2496,2235,261,844,1391,66223.0,0.557
30164,2018,4356,2336,2458,2127,331,872,1255,76322.0,0.511
30164,2019,4421,2420,2487,2199,288,835,1364,76188.0,0.548
30165,2010,20062,11843,13880,11385,2495,6498,4887,83198.83,0.352
30165,2011,20481,12246,14033,11490,2543,6463,5027,84713.5,0.358
30165,2012,20067,11925,13837,11338,2499,6273,5065,83777.83,0.366
30165,2013,20535,11627,13781,11210,2571,6061,5149,84620.33,0.374
30165,2014,21716,12181,14030,11454,2576,6201,5253,83701.17,0.374
30165,2015,22724,13124,14254,11819,2435,6116,5703,90415.33,0.4
30165,2016,22825,13355,14356,11962,2394,6264,5698,91322.0,0.397
30165,2017,23852,13828,14603,12090,2513,6436,5654,96469.67,0.387
30165,2018,24024,14223,15043,12275,2768,6564,5711,99821.33,0.38
30165,2019,24635,15323,15578,12985,2593,6695,6290,104262.33,0.404
30168,2010,57852,8875,24312,21449,2863,12323,9126,45981.11,0.375
30168,2011,58169,8971,24363,21549,2814,11920,9629,44789.11,0.395
30168,2012,59168,9280,24670,21891,2779,11870,10021,45360.0,0.406
30168,2013,60037,8627,24761,21854,2907,11462,10392,43468.11,0.42
30168,2014,60131,8647,24829,22055,2774,11261,10794,45858.78,0.435
30168,2015,60635,8965,24901,22188,2713,11016,11172,45849.0,0.449
30168,2016,60381,9274,24964,22317,2647,10989,11328,48166.0,0.454
30168,2017,61453,8891,25180,22512,2668,11111,11401,49695.67,0.453
30168,2018,63087,9872,25195,22966,2229,10873,12093,53902.44,0.48
30168,2019,64038,11087,25321,23123,2198,10849,12274,57272.78,0.485
30169,2010,8462,1047,3973,3294,679,1454,1840,34754.0,0.463
30169,2011,7944,1021,3929,3194,735,1379,1815,35017.0,0.462
30169,2012,8769,1013,4013,3397,616,1524,1873,37371.0,0.467
30169,2013,9333,871,4077,3405,672,1452,1953,35094.0,0.479
30169,2014,9591,985,4100,3576,524,1486,2090,37061.0,0.51
30169,2015,9836,1004,3916,3561,355,1322,2239,37198.0,0.572
30169,2016,10088,1206,3914,3621,293,1365,2256,38577.0,0.576
30169,2017,9596,1234,3846,3613,233,1324,2289,40015.0,0.595
30169,2018,9288,1452,3916,3662,254,1325,2337,43030.0,0.597
30169,2019,9110,1455,3932,3634,298,1414,2220,46118.0,0.565
30170,2010,20738,1751,8632,7469,1163,5570,1899,43075.5,0.22
30170,2011,20805,1882,8732,7625,1107,5677,1948,41363.75,0.223
30170,2012,21416,1970,8816,7711,1105,5748,1963,42276.5,0.223
30170,2013,20578,2001,8641,7418,1223,5628,1790,44224.0,0.207
30170,2014,21064,2182,8588,7459,1129,5611,1848,45289.0,0.215
30170,2015,20866,2259,8546,7504,1042,5357,2147,42856.25,0.251
30170,2016,20974,2439,8628,7463,1165,5483,1980,48107.5,0.229
30170,2017,21784,2404,8685,7549,1136,5546,2003,48888.75,0.231
30170,2018,21596,2286,8697,7612,1085,5557,2055,47590.25,0.236
30170,2019,22000,2390,8768,7805,963,5912,1893,51720.25,0.216
30171,2010,11270,1321,4302,3860,442,3009,851,56688.0,0.198
30171,2011,11218,1523,4408,3763,645,2929,834,65935.5,0.189
30171,2012,11113,1487,4403,3668,735,2918,750,71236.0,0.17
30171,2013,11285,1546,4464,3862,602,3101,761,67384.0,0.17
30171,2014,11257,1660,4340,3865,475,3245,620,73831.5,0.143
30171,2015,10692,1786,4364,3910,454,3138,772,62284.5,0.177
30171,2016,11646,1834,4336,4155,181,3316,839,62676.0,0.193
30171,2017,11534,1838,4390,4181,209,3404,777,65883.5,0.177
30171,2018,11189,1614,4260,3994,266,3255,739,70060.0,0.173
30171,2019,11783,1611,4456,4193,263,3412,781,68311.0,0.175
30172,2010,4433,2536,2210,2023,187,1688,335,114922.0,0.152
30172,2011,4327,2521,2117,1896,221,1539,357,125792.0,0.169
30172,2012,4225,2347,2055,1848,207,1479,369,123676.0,0.18
30172,2013,4319,2336,2017,1877,140,1544,333,125819.0,0.165
30172,2014,4469,2394,2006,1807,199,1504,303,128578.0,0.151
30172,2015,4650,2647,2044,1847,197,1521,326,139487.0,0.159
30172,2016,4781,2633,2045,1856,189,1509,347,138276.0,0.17
30172,2017,5183,2898,2098,1969,129,1574,395,149450.0,0.188
30172,2018,5373,2967,2151,1997,154,1534,463,154911.0,0.215
30172,2019,5410,3142,2140,2084,56,1572,512,168396.0,0.239
30173,2010,34529,4055,15463,13386,2077,9164,4222,45263.78,0.273
30173,2011,35519,4598,15872,13787,2085,9492,4295,45741.11,0.271
30173,2012,34964,4470,16077,14014,2063,9670,4344,45354.33,0.27
30173,2013,35648,4859,16158,14294,1864,9892,4402,45478.22,0.272
30173,2014,36113,4903,16192,14254,1938,9942,4312,45842.44,0.266
30173,2015,36395,4870,16207,14363,1844,9974,4389,46922.67,0.271
30173,2016,36354,4692,16255,14497,1758,9862,4635,46202.11,0.285
30173,2017,35971,4895,16342,14523,1819,9746,4777,50728.78,0.292
30173,2018,36541,4972,16477,14747,1730,9934,4813,53133.44,0.292
30173,2019,36305,5590,16526,14782,1744,10236,4546,57111.44,0.275
30175,2010,36582,4850,17613,14094,3519,10773,3321,48172.0,0.189
30175,2011,37446,5231,17940,14078,3862,10888,3190,49629.29,0.178
30175,2012,37060,5562,17926,14274,3652,11029,3245,50294.86,0.181
30175,2013,38296,6042,17972,14396,3576,11175,3221,50571.43,0.179
30175,2014,38332,6461,18208,14421,3787,11213,3208,49611.29,0.176
30175,2015,39253,7185,18323,14833,3490,11560,3273,51451.14,0.179
30175,2016,38938,7344,18234,14987,3247,11486,3501,51928.57,0.192
30175,2017,39626,7613,18613,15181,3432,11508,3673,56236.86,0.197
30175,2018,39317,7120,18697,15345,3352,11555,3790,58749.0,0.203
30175,2019,40377,7172,18929,15651,3278,11884,3767,61748.71,0.199
30176,2010,42988,4437,19223,16257,2966,12323,3934,46512.89,0.205
30176,2011,43876,4293,19269,16262,3007,12411,3851,46822.44,0.2
30176,2012,45041,4688,19742,16797,2945,12635,4162,47825.11,0.211
30176,2013,45946,5031,19643,16718,2925,12587,4131,47896.0,0.21
30176,2014,45955,5125,19428,16369,3059,12312,4057,48591.56,0.209
30176,2015,46577,4953,19411,16435,2976,12249,4186,48241.11,0.216
30176,2016,46397,5250,19158,16521,2637,12200,4321,50731.56,0.226
30176,2017,45593,5327,19053,16310,2743,11839,4471,53740.67,0.235
30176,2018,45631,5377,19141,16509,2632,11888,4621,55899.56,0.241
30176,2019,46561,5830,19856,17491,2365,12460,5031,57332.89,0.253
30177,2010,5567,642,2380,2244,136,1951,293,47620.0,0.123
30177,2011,5735,686,2384,2178,206,1855,323,51731.0,0.135
30177,2012,6163,623,2488,2336,152,1859,477,47500.0,0.192
30177,2013,6139,659,2578,2309,269,1923,386,47413.0,0.15
30177,2014,6152,730,2606,2264,342,1749,515,45319.0,0.198
30177,2015,5741,661,2560,2185,375,1647,538,48210.0,0.21
30177,2016,5888,687,2469,2091,378,1618,473,56220.0,0.192
30177,2017,5786,795,2411,1985,426,1613,372,63349.0,0.154
30177,2018,6346,823,2487,2223,264,1798,425,58750.0,0.171
30177,2019,6110,785,2425,2154,271,1742,412,64706.0,0.17
30178,2010,26481,2312,9832,8731,1101,7267,1464,52820.17,0.149
30178,2011,26856,2668,10140,9060,1080,7512,1548,53337.5,0.153
30178,2012,26578,2775,10118,9087,1031,7648,1439,52790.33,0.142
30178,2013,26041,2689,10164,9178,986,7597,1581,51789.67,0.156
30178,2014,25909,2777,10304,9334,970,7767,1567,52264.0,0.152
30178,2015,25611,2777,10268,9243,1025,7602,1641,52720.0,0.16
30178,2016,25569,2605,10348,9310,1038,7617,1693,50462.67,0.164
30178,2017,26474,2726,10612,9612,1000,7795,1817,54442.67,0.171
30178,2018,27784,2945,10801,9735,1066,8026,1709,58428.33,0.158
30178,2019,27679,3174,10744,9658,1086,8057,1601,64317.83,0.149
30179,2010,92044,10319,37293,32915,4378,26481,6434,51047.43,0.173
30179,2011,96790,11354,38620,34323,4297,27156,7167,51287.93,0.186
30179,2012,100106,12083,39803,35513,4290,27948,7565,50512.29,0.19
30179,2013,100644,11851,40315,35859,4456,27795,8064,49322.86,0.2
30179,2014,100974,12089,40100,35774,4326,27262,8512,48838.07,0.212
30179,2015,102713,12508,40231,36117,4114,27228,8889,48954.93,0.221
30179,2016,103510,13207,39909,35878,4031,26793,9085,49132.57,0.228
30179,2017,105169,13655,40170,36342,3828,26490,9852,52325.5,0.245
30179,2018,107634,14934,40561,37017,3544,27086,9931,55952.07,0.245
30179,2019,110193,15206,41429,38080,3349,27448,10632,60009.21,0.257
30180,2010,83374,9642,33160,29572,3588,23433,6139,56219.64,0.185
30180,2011,88199,10693,34562,31052,3510,24713,6339,57391.0,0.183
30180,2012,89799,11413,35135,31744,3391,25196,6548,58390.64,0.186
30180,2013,91486,11432,35474,32272,3202,25523,6749,57703.09,0.19
30180,2014,93980,11645,35863,32790,3073,25242,7548,55890.09,0.21
30180,2015,95169,11526,35694,32883,2811,25022,7861,55252.64,0.22
30180,2016,94879,11376,35718,32984,2734,25075,7909,55957.09,0.221
30180,2017,95039,12040,35840,33344,2496,24808,8536,58451.45,0.238
30180,2018,97255,12854,36005,33578,2427,24884,8694,61544.09,0.241
30180,2019,96569,12440,35897,33573,2324,25111,8462,66405.91,0.236
30182,2010,30539,3490,13503,11514,1989,8710,2804,47253.17,0.208
30182,2011,30916,3255,13535,11487,2048,8722,2765,46529.83,0.204
30182,2012,31859,3375,13775,11718,2057,8750,2968,46495.0,0.215
30182,2013,32254,3364,13547,11492,2055,8564,2928,45555.17,0.216
30182,2014,31303,3372,13334,11118,2216,8221,2897,45950.33,0.217
30182,2015,31679,3366,13366,11263,2103,8151,3112,44708.5,0.233
30182,2016,31729,3539,13094,11325,1769,7984,3341,47749.17,0.255
30182,2017,31752,3792,13161,11437,1724,8044,3393,49331.5,0.258
30182,2018,32172,4029,13511,11711,1800,8337,3374,52861.17,0.25
30182,2019,32974,4124,13995,12489,1506,8872,3617,54529.17,0.258
30183,2010,12992,1939,5514,4767,747,3870,897,56371.33,0.163
30183,2011,13295,2115,5482,4788,694,3949,839,60855.33,0.153
30183,2012,13369,2139,5534,4801,733,4007,794,65315.0,0.143
30183,2013,13244,2025,5584,4687,897,3915,772,63057.33,0.138
30183,2014,13778,2222,5532,4811,721,3980,831,66479.0,0.15
30183,2015,13949,2040,5534,4872,662,3984,888,61245.0,0.16
30183,2016,14522,2096,5609,4935,674,3984,951,60359.33,0.17
30183,2017,14606,2071,5693,4996,697,4058,938,64112.33,0.165
30183,2018,14496,2330,5545,5071,474,4118,953,72477.0,0.172
30183,2019,14547,2401,5736,5229,507,4267,962,70730.67,0.168
30184,2010,43883,6673,17964,15971,1993,12027,3944,53874.83,0.22
30184,2011,45988,6968,18567,16254,2313,11861,4393,57709.17,0.237
30184,2012,45688,7148,18574,16130,2444,11668,4462,60415.0,0.24
30184,2013,45406,7111,18521,15999,2522,11507,4492,59008.5,0.243
30184,2014,47166,8114,18491,16573,1918,11843,4730,63667.17,0.256
30184,2015,47314,8296,18521,16871,1650,11852,5019,60201.0,0.271
30184,2016,49025,8857,18604,17198,1406,12488,4710,62627.83,0.253
30184,2017,49867,9079,18928,17604,1324,13075,4529,63365.0,0.239
30184,2018,49337,8955,18943,17717,1226,13166,4551,69122.17,0.24
30184,2019,49491,9077,19762,18353,1409,13584,4769,69321.5,0.241
30185,2010,27922,3842,11069,9617,1452,7810,1807,59537.25,0.163
30185,2011,28230,3943,11338,9760,1578,7750,2010,61354.0,0.177
30185,2012,28408,4217,11369,9772,1597,7814,1958,59922.25,0.172
30185,2013,28815,4367,11337,9923,1414,7630,2293,59260.25,0.202
30185,2014,28686,4666,11323,9907,1416,7735,2172,60015.25,0.192
30185,2015,28328,4688,11304,9901,1403,7694,2207,58933.75,0.195
30185,2016,29515,4929,11570,10410,1160,8289,2121,59877.0,0.183
30185,2017,29725,5224,11636,10623,1013,8473,2150,61664.25,0.185
30185,2018,30408,5327,11915,10873,1042,8799,2074,63254.25,0.174
30185,2019,31522,5397,12049,11251,798,9166,2085,66804.25,0.173
30187,2010,36027,5351,13885,12450,1435,10255,2195,61244.83,0.158
30187,2011,37712,5856,14767,13076,1691,10841,2235,63493.17,0.151
30187,2012,37501,6260,14741,13009,1732,10603,2406,62233.83,0.163
30187,2013,38887,6483,14760,13416,1344,10962,2454,62528.33,0.166
30187,2014,39658,6658,14960,13605,1355,11057,2548,61969.83,0.17
30187,2015,39385,6820,14908,13474,1434,10870,2604,61678.5,0.175
30187,2016,39118,6659,14912,13692,1220,10965,2727,62113.5,0.183
30187,2017,39418,6680,15130,14044,1086,11038,3006,62826.0,0.199
30187,2018,40936,7004,15263,14130,1133,11142,2988,65301.83,0.196
30187,2019,41189,7115,15267,14240,1027,11247,2993,69648.5,0.196
30188,2010,115314,29475,43422,41221,2201,34406,6815,77154.87,0.157
30188,2011,117463,30147,43775,41742,2033,34844,6898,78715.8,0.158
30188,2012,118822,31664,44199,41695,2504,34782,6913,79986.87,0.156
30188,2013,120328,32177,44534,41932,2602,34743,7189,78870.4,0.161
30188,2014,119213,32255,44559,42337,2222,34664,7673,78538.53,0.172
30188,2015,120824,32333,45535,43213,2322,34898,8315,79612.67,0.183
30188,2016,125152,33942,46819,44197,2622,35083,9114,81423.93,0.195
30188,2017,128050,35258,48142,45758,2384,35417,10341,83798.0,0.215
30188,2018,130532,37232,49218,46861,2357,36337,10524,87537.2,0.214
30188,2019,135266,39519,50437,48218,2219,37402,10816,92622.4,0.214
30189,2010,51550,11515,19875,18538,1337,14022,4516,69875.38,0.227
30189,2011,51385,11516,19963,18571,1392,13858,4713,69844.38,0.236
30189,2012,52115,11773,19908,18471,1437,13837,4634,71093.12,0.233
30189,2013,52649,11825,20088,18710,1378,13767,4943,69338.62,0.246
30189,2014,53236,11763,20216,18937,1279,13803,5134,70601.5,0.254
30189,2015,54232,12045,20279,19125,1154,13778,5347,71699.75,0.264
30189,2016,54870,13030,20778,19727,1051,14184,5543,73894.62,0.267
30189,2017,56047,13449,21398,20366,1032,14257,6109,76323.5,0.285
30189,2018,56909,13987,21864,20951,913,14551,6400,79674.88,0.293
30189,2019,58102,14860,22118,21334,784,15115,6219,79872.62,0.281
30204,2010,58844,4978,25185,21235,3950,15141,6094,42076.67,0.242
30204,2011,59678,5867,25687,21560,4127,15514,6046,43263.33,0.235
30204,2012,59545,6181,25798,21799,3999,15991,5808,43170.5,0.225
30204,2013,59724,6541,25833,21904,3929,16199,5705,43277.75,0.221
30204,2014,59604,6962,25835,21874,3961,16124,5750,42350.75,0.223
30204,2015,59536,7213,25655,21905,3750,16132,5773,44009.33,0.225
30204,2016,59647,7072,25659,21903,3756,16033,5870,43780.67,0.229
30204,2017,60434,7384,26067,22185,3882,15972,6213,46119.75,0.238
30204,2018,61327,7123,26398,22662,3736,16296,6366,49447.17,0.241
30204,2019,61782,7168,26507,22706,3801,16641,6065,53732.75,0.229
30205,2010,13090,2132,4893,4495,398,4058,437,67825.0,0.089
30205,2011,13232,2184,4990,4657,333,4164,493,71436.33,0.099
30205,2012,13055,2316,5019,4721,298,4160,561,67032.67,0.112
30205,2013,13200,2600,4976,4703,273,4199,504,71216.67,0.101
30205,2014,13564,2893,5025,4791,234,4270,521,76688.67,0.104
30205,2015,13421,3195,4993,4811,182,4384,427,74549.67,0.086
30205,2016,13665,3108,5063,4791,272,4353,438,76115.33,0.087
30205,2017,13823,3129,5086,4836,250,4400,436,79187.33,0.086
30205,2018,13737,2929,5142,4863,279,4477,386,77362.0,0.075
30205,2019,14240,2999,5251,4993,258,4667,326,79439.33,0.062
30206,2010,63091,7044,26343,22720,3623,17428,5292,46641.93,0.201
30206,2011,64082,7384,26804,22937,3867,17723,5214,48179.57,0.195
30206,2012,65211,7517,27340,23626,3714,18134,5492,48143.71,0.201
30206,2013,65373,7572,27066,23416,3650,18002,5414,48130.29,0.2
30206,2014,65257,7529,26935,22959,3976,17804,5155,47876.14,0.191
30206,2015,65348,7315,27032,23112,3920,17825,5287,48629.71,0.196
30206,2016,65369,7241,26701,23250,3451,17656,5594,48918.79,0.21
30206,2017,65058,7605,26776,23242,3534,17389,5853,52225.43,0.219
30206,2018,65974,7645,27166,23649,3517,17635,6014,55222.57,0.221
30206,2019,66184,8054,27515,24280,3235,18026,6254,59195.21,0.227
30212,2010,5790,334,2412,1951,461,862,1089,27199.0,0.451
30212,2011,5976,327,2397,1896,501,826,1070,25507.0,0.446
30212,2012,5999,359,2463,1968,495,830,1138,26045.0,0.462
30212,2013,5039,261,2402,1735,667,682,1053,22992.0,0.438
30212,2014,4923,259,2500,1695,805,641,1054,23337.0,0.422
30212,2015,5493,300,2475,1639,836,537,1102,22203.0,0.445
30212,2016,6075,259,2515,1707,808,611,1096,25011.0,0.436
30212,2017,5230,91,2402,1546,856,579,967,24865.0,0.403
30212,2018,5603,111,2411,1673,738,581,1092,29059.0,0.453
30212,2019,6366,180,2471,1969,502,788,1181,28935.0,0.478
30213,2010,84619,13595,35772,31030,4742,22570,8460,54170.36,0.236
30213,2011,88594,13953,36549,31847,4702,22817,9030,54065.82,0.247
30213,2012,92745,15302,37823,32908,4915,23622,9286,54107.45,0.246
30213,2013,92693,14592,38310,33166,5144,23334,9832,52202.27,0.257
30213,2014,92144,14782,37848,32761,5087,22650,10111,51723.91,0.267
30213,2015,93334,15847,38174,33351,4823,22407,10944,50177.82,0.287
30213,2016,95560,16864,38177,33517,4660,21592,11925,51834.64,0.312
30213,2017,96797,16608,39050,34533,4517,21387,13146,53045.0,0.337
30213,2018,99144,18348,39018,35172,3846,22210,12962,55987.27,0.332
30213,2019,103073,19358,39847,36581,3266,22584,13997,60958.27,0.351
30214,2010,76069,17906,30984,28282,2702,22652,5630,72621.85,0.182
30214,2011,78167,18234,31456,28739,2717,22963,5776,71438.08,0.184
30214,2012,79895,19200,31823,28831,2992,22967,5864,73106.15,0.184
30214,2013,80303,18863,31981,29116,2865,22579,6537,72232.85,0.204
30214,2014,80088,19123,31479,28744,2735,21615,7129,73255.38,0.226
30214,2015,80743,19427,31812,29126,2686,21685,7441,73096.62,0.234
30214,2016,81640,20358,31987,29536,2451,21308,8228,75660.92,0.257
30214,2017,80958,20182,32264,30096,2168,21508,8588,78692.23,0.266
30214,2018,83136,21421,32219,30259,1960,22046,8213,78016.85,0.255
30214,2019,83047,21045,32372,30497,1875,22592,7905,81713.23,0.244
30215,2010,56992,13307,21954,20180,1774,17010,3170,80148.55,0.144
30215,2011,57561,13590,22178,20323,1855,17235,3088,81154.18,0.139
30215,2012,58732,14144,22284,20504,1780,17215,3289,83134.27,0.148
30215,2013,58876,14358,22290,20635,1655,17123,3512,81122.0,0.158
30215,2014,59769,15094,22472,21079,1393,17263,3816,83690.0,0.17
30215,2015,61040,15369,22535,21237,1298,17497,3740,83639.0,0.166
30215,2016,61091,16111,22629,21422,1207,17460,3962,86369.18,0.175
30215,2017,62555,16707,22701,21678,1023,17659,4019,89205.73,0.177
30215,2018,63957,17302,23004,21958,1046,17862,4096,90919.09,0.178
30215,2019,65848,17490,23329,22182,1147,18431,3751,95268.18,0.161
30216,2010,16084,1106,7315,5962,1353,4478,1484,48367.0,0.203
30216,2011,16400,946,7266,6080,1186,4605,1475,46648.5,0.203
30216,2012,16055,1015,7173,5898,1275,4380,1518,47924.0,0.212
30216,2013,15799,938,7024,5822,1202,4271,1551,46334.5,0.221
30216,2014,15604,1107,6969,5745,1224,4218,1527,47089.0,0.219
30216,2015,15875,1165,6993,5823,1170,4205,1618,44521.0,0.231
30216,2016,15819,1199,6998,5754,1244,4088,1666,42609.5,0.238
30216,2017,16043,1334,7110,6077,1033,4156,1921,43071.0,0.27
30216,2018,16187,1540,7069,6134,935,4255,1879,45248.5,0.266
30216,2019,16328,1573,7131,6258,873,4282,1976,48139.0,0.277
30217,2010,43063,3714,18860,15983,2877,11665,4318,42881.38,0.229
30217,2011,44111,4230,19205,16106,3099,11814,4292,43923.38,0.223
30217,2012,44675,4724,19366,16435,2931,12346,4089,44556.62,0.211
30217,2013,44607,5026,19415,16378,3037,12447,3931,44859.25,0.202
30217,2014,44916,5568,19426,16416,3010,12399,4017,43384.38,0.207
30217,2015,45323,5563,19434,16444,2990,12179,4265,43983.75,0.219
30217,2016,45237,5789,19364,16459,2905,12337,4122,44464.5,0.213
30217,2017,45888,6111,19692,16617,3075,12206,4411,46518.88,0.224
30217,2018,46298,5820,19725,16881,2844,12388,4493,49567.62,0.228
30217,2019,46820,5689,20005,17150,2855,12760,4390,52827.12,0.219
30218,2010,13590,675,5674,4869,805,3820,1049,40324.0,0.185
30218,2011,13817,659,5660,4749,911,3587,1162,40276.0,0.205
30218,2012,13578,748,5750,4783,967,3639,1144,39812.5,0.199
30218,2013,12986,670,5795,4840,955,3653,1187,38002.0,0.205
30218,2014,12571,668,5804,4754,1050,3418,1336,36045.5,0.23
30218,2015,12220,655,5748,4648,1100,3315,1333,36327.5,0.232
30218,2016,12107,686,5654,4604,1050,3282,1322,35081.0,0.234
30218,2017,11896,715,5682,4662,1020,3432,1230,36272.5,0.216
30218,2018,12251,874,5649,4631,1018,3318,1313,36048.0,0.232
30218,2019,12242,862,5827,4661,1166,3308,1353,37978.5,0.232
30220,2010,18238,1234,6977,6253,724,5126,1127,50056.0,0.162
30220,2011,18685,1383,7128,6298,830,5116,1182,47558.67,0.166
30220,2012,19017,1527,7325,6478,847,5267,1211,45482.33,0.165
30220,2013,18182,1576,7416,6596,820,5323,1273,46579.33,0.172
30220,2014,17757,1568,7360,6367,993,4953,1414,45543.0,0.192
30220,2015,17285,1394,7277,6388,889,4883,1505,46654.33,0.207
30220,2016,16903,1362,7227,6326,901,4804,1522,48961.67,0.211
30220,2017,16581,1428,7213,6338,875,4846,1492,50237.67,0.207
30220,2018,17122,1639,7257,6478,779,4831,1647,52961.67,0.227
30220,2019,17813,1873,7447,6629,818,5085,1544,61250.67,0.207
30222,2010,16809,923,7191,6057,1134,4586,1471,40092.67,0.205
30222,2011,16789,859,7191,5872,1319,4341,1531,40449.0,0.213
30222,2012,16615,956,7350,5981,1369,4506,1475,39773.33,0.201
30222,2013,16229,962,7397,6099,1298,4520,1579,38455.33,0.213
30222,2014,15903,1063,7367,5996,1371,4243,1753,37495.33,0.238
30222,2015,15759,1076,7283,5890,1393,4191,1699,37478.67,0.233
30222,2016,15748,1191,7155,5893,1262,4176,1717,36050.33,0.24
30222,2017,15946,1228,7231,6056,1175,4326,1730,37064.33,0.239
30222,2018,16026,1349,7185,5996,1189,4266,1730,36503.33,0.241
30222,2019,16053,1301,7334,6020,1314,4221,1799,37977.67,0.245
30223,2010,90041,8836,35430,31398,4032,22037,9361,45174.8,0.264
30223,2011,90138,9168,35761,31317,4444,21554,9763,44191.33,0.273
30223,2012,90880,9737,36025,31426,4599,21178,10248,43811.13,0.284
30223,2013,91837,9948,36280,31645,4635,21649,9996,44114.13,0.276
30223,2014,92656,10137,36465,31901,4564,21364,10537,42402.67,0.289
30223,2015,92880,10500,36615,31524,5091,20921,10603,42159.2,0.29
30223,2016,93942,10824,37138,32243,4895,21476,10767,43521.93,0.29
30223,2017,94139,11076,37254,32835,4419,21767,11068,44771.47,0.297
30223,2018,94342,10891,37233,33174,4059,21577,11597,45559.07,0.311
30223,2019,95154,12126,37601,33531,4070,22194,11337,48815.47,0.302
30224,2010,81751,7288,33757,29141,4616,20898,8243,45477.06,0.244
30224,2011,82234,8253,34476,29340,5136,21077,8263,45759.81,0.24
30224,2012,82804,9048,34603,29608,4995,21250,8358,45441.88,0.242
30224,2013,85653,9450,35260,30371,4889,21810,8561,45754.19,0.243
30224,2014,86258,9729,35459,30537,4922,21683,8854,44843.56,0.25
30224,2015,85673,10042,35516,30399,5117,21452,8947,44686.12,0.252
30224,2016,85266,10035,35353,30498,4855,21358,9140,44329.0,0.259
30224,2017,86060,10585,35778,31116,4662,21611,9505,47333.31,0.266
30224,2018,87007,10575,36036,31686,4350,22258,9428,49025.69,0.262
30224,2019,88135,11636,36505,32052,4453,22859,9193,52417.38,0.252
30228,2010,63165,9008,23927,20979,2948,17174,3805,59811.0,0.159
30228,2011,64779,9228,24716,21685,3031,17098,4587,58189.12,0.186
30228,2012,65607,9122,24941,21689,3252,16824,4865,57371.62,0.195
30228,2013,67391,10136,24600,21821,2779,16935,4886,58282.5,0.199
30228,2014,69383,10792,24942,22724,2218,17057,5667,55832.0,0.227
30228,2015,71788,11662,25636,23428,2208,17497,5931,56914.75,0.231
30228,2016,71436,12230,25585,23600,1985,17902,5698,60184.25,0.223
30228,2017,73498,12833,25811,24302,1509,18054,6248,60589.25,0.242
30228,2018,73916,13045,26349,24588,1761,18175,6413,61931.0,0.243
30228,2019,75802,13432,26994,24917,2077,18703,6214,66106.5,0.23
30229,2010,5306,921,2019,1891,128,1606,285,77520.0,0.141
30229,2011,5530,945,2062,1954,108,1572,382,72917.0,0.185
30229,2012,5583,998,2239,2032,207,1584,448,62857.0,0.2
30229,2013,5966,1190,2222,2085,137,1546,539,73693.0,0.243
30229,2014,5925,1069,2239,2088,151,1535,553,61902.0,0.247
30229,2015,5815,1202,2249,2115,134,1601,514,75573.0,0.229
30229,2016,5825,1321,2193,2040,153,1626,414,70179.0,0.189
30229,2017,5763,1454,2125,2028,97,1734,294,70781.0,0.138
30229,2018,5994,1643,2271,2129,142,1843,286,73880.0,0.126
30229,2019,6003,1757,2211,2090,121,1882,208,86981.0,0.094
30230,2010,36330,2740,15869,13340,2529,10099,3241,44159.83,0.204
30230,2011,37607,3130,16181,13347,2834,10225,3122,44482.33,0.193
30230,2012,37621,3455,16348,13667,2681,10499,3168,44478.17,0.194
30230,2013,37791,3800,16524,13964,2560,10812,3152,44161.17,0.191
30230,2014,37556,3920,16820,13964,2856,10563,3401,43261.33,0.202
30230,2015,37452,4008,16814,13943,2871,10543,3400,43959.17,0.202
30230,2016,36883,4229,16570,13912,2658,10384,3528,42557.83,0.213
30230,2017,36843,4477,16763,14026,2737,10386,3640,44455.5,0.217
30230,2018,36622,4464,16811,13968,2843,10202,3766,46240.33,0.224
30230,2019,37114,4514,17077,14154,2923,10523,3631,50517.33,0.213
30233,2010,61915,4644,24957,21311,3646,16755,4556,50635.5,0.183
30233,2011,64100,5092,25433,21652,3781,17146,4506,51847.0,0.177
30233,2012,64347,5404,25476,21545,3931,17013,4532,51208.62,0.178
30233,2013,65198,5914,25344,21618,3726,17056,4562,49931.0,0.18
30233,2014,64574,6531,25601,21524,4077,16682,4842,49080.12,0.189
30233,2015,64798,6836,25628,21550,4078,16532,5018,48594.75,0.196
30233,2016,65042,7101,25683,21804,3879,16562,5242,47676.25,0.204
30233,2017,65828,7636,26114,22451,3663,16713,5738,49793.12,0.22
30233,2018,65773,7926,26388,22880,3508,17170,5710,51494.75,0.216
30233,2019,67831,7964,26724,23481,3243,17395,6086,54153.5,0.228
30234,2010,17216,1430,5413,4888,525,4112,776,62255.0,0.143
30234,2011,18154,1571,5831,5276,555,4428,848,66020.5,0.145
30234,2012,18407,1578,5924,5288,636,4392,896,63122.5,0.151
30234,2013,18340,1717,5999,5357,642,4446,911,60860.0,0.152
30234,2014,18569,1738,6001,5406,595,4381,1025,57223.5,0.171
30234,2015,18232,1704,5844,5288,556,4115,1173,51630.0,0.201
30234,2016,17959,1779,5882,5301,581,4088,1213,48744.0,0.206
30234,2017,18370,1988,6020,5529,491,4357,1172,49168.5,0.195
30234,2018,18465,1905,6164,5650,514,4478,1172,50531.5,0.19
30234,2019,19319,2125,6330,5786,544,4526,1260,52995.0,0.199
30236,2010,110648,14146,43214,36397,6817,22417,13980,47588.21,0.324
30236,2011,109188,13958,43795,36510,7285,22408,14102,46295.16,0.322
30236,2012,110315,13608,44109,36586,7523,21710,14876,46753.58,0.337
30236,2013,112083,14353,44031,37006,7025,21209,15797,45319.58,0.359
30236,2014,112999,14829,44194,37540,6654,21071,16469,44863.37,0.373
30236,2015,115793,15130,44303,38044,6259,20967,17077,44426.68,0.385
30236,2016,117650,15004,44014,38233,5781,20249,17984,45599.84,0.409
30236,2017,118683,16016,44201,38744,5457,20486,18258,47251.42,0.413
30236,2018,120555,16741,44511,39288,5223,20697,18591,49429.95,0.418
30236,2019,123775,17310,44530,39990,4540,20643,19347,54361.26,0.434
30237,2010,9253,751,1992,1735,257,925,810,41831.0,0.407
30237,2011,6849,338,1791,1455,336,792,663,42287.0,0.37
30237,2012,7167,313,1888,1543,345,829,714,39604.0,0.378
30237,2013,6856,328,2028,1798,230,942,856,37052.0,0.422
30237,2014,6554,333,2049,1744,305,911,833,39167.0,0.407
30237,2015,6440,329,2053,1714,339,881,833,33828.0,0.406
30237,2016,6906,410,1990,1751,239,786,965,30996.0,0.485
30237,2017,7282,438,2245,1969,276,772,1197,29157.0,0.533
30237,2018,7827,612,2284,2023,261,787,1236,34619.0,0.541
30237,2019,7938,564,2247,2013,234,775,1238,34517.0,0.551
30238,2010,87872,10345,32910,28147,4763,19875,8272,49671.07,0.251
30238,2011,85735,10590,33565,27935,5630,19767,8168,47908.07,0.243
30238,2012,87131,10747,34173,28534,5639,19666,8868,47183.2,0.26
30238,2013,88048,10810,33986,28649,5337,19108,9541,46945.07,0.281
30238,2014,88199,11771,33680,28877,4803,18349,10528,47572.07,0.313
30238,2015,89765,12160,33772,29401,4371,18087,11314,46533.6,0.335
30238,2016,92123,11997,33519,29912,3607,17500,12412,46911.33,0.37
30238,2017,92549,12690,33300,30297,3003,17621,12676,49860.4,0.381
30238,2018,93402,13100,33476,30625,2851,17709,12916,51913.53,0.386
30238,2019,94361,12743,33418,30740,2678,17803,12937,54593.93,0.387
30240,2010,47960,5439,19576,16924,2652,12297,4627,48773.75,0.236
30240,2011,48214,5046,19768,16957,2811,12006,4951,49007.38,0.25
30240,2012,47778,5447,19417,16670,2747,11605,5065,48972.25,0.261
30240,2013,46897,5334,19018,16283,2735,11143,5140,47793.12,0.27
30240,2014,46849,6009,19160,16869,2291,11507,5362,48434.38,0.28
30240,2015,47500,6213,19245,17119,2126,11561,5558,49724.75,0.289
30240,2016,47446,6588,19272,17351,1921,11517,5834,49251.25,0.303
30240,2017,47941,6551,19471,17406,2065,11691,5715,51026.38,0.294
30240,2018,48848,6548,19869,17890,1979,12150,5740,54559.0,0.289
30240,2019,48780,6268,19881,17897,1984,12124,5773,56587.0,0.29
30241,2010,32468,4408,13911,11805,2106,8324,3481,48470.4,0.25
30241,2011,32132,3982,13953,11649,2304,8010,3639,49472.6,0.261
30241,2012,32075,3923,13725,11471,2254,7580,3891,48314.2,0.283
30241,2013,31790,3952,13393,11248,2145,7374,3874,46891.6,0.289
30241,2014,32177,4446,13310,11634,1676,7464,4170,47620.8,0.313
30241,2015,33088,4763,13481,12049,1432,7735,4314,49439.8,0.32
30241,2016,33494,5184,13470,12316,1154,7711,4605,49764.6,0.342
30241,2017,34170,5292,13491,12317,1174,7870,4447,50786.0,0.33
30241,2018,34087,5266,13769,12587,1182,8168,4419,52931.2,0.321
30241,2019,33978,5075,13768,12614,1154,8228,4386,53554.2,0.319
30248,2010,53765,5821,18396,16749,1647,14589,2160,63991.33,0.117
30248,2011,55238,6250,19272,17505,1767,14877,2628,65608.5,0.136
30248,2012,56417,6484,19704,17621,2083,14503,3118,63623.5,0.158
30248,2013,57684,7363,20027,18259,1768,15148,3111,60522.33,0.155
30248,2014,57950,7581,20048,18326,1722,15073,3253,59298.83,0.162
30248,2015,57725,7574,20115,18146,1969,14851,3295,57714.0,0.164
30248,2016,59089,8177,20703,18859,1844,15323,3536,57362.0,0.171
30248,2017,59412,8419,21056,19404,1652,15746,3658,58872.83,0.174
30248,2018,60431,8781,21699,19849,1850,15984,3865,61915.17,0.178
30248,2019,62940,9303,22613,20798,1815,16506,4292,66168.0,0.19
30250,2010,3020,218,1178,1004,174,826,178,44949.0,0.151
30250,2011,3409,237,1344,1152,192,875,277,45136.0,0.206
30250,2012,3279,230,1257,1048,209,803,245,44091.0,0.195
30250,2013,4141,343,1113,958,155,667,291,42692.0,0.261
30250,2014,3740,351,1142,952,190,621,331,38191.0,0.29
30250,2015,3742,338,1141,983,158,648,335,39222.0,0.294
30250,2016,3631,330,999,835,164,579,256,47804.0,0.256
30250,2017,3745,333,1068,913,155,593,320,44063.0,0.3
30250,2018,3596,274,1201,967,234,754,213,44025.0,0.177
30250,2019,3894,259,1231,1002,229,775,227,45800.0,0.184
30251,2010,8407,337,3207,2812,395,2317,495,45804.0,0.154
30251,2011,8448,380,3242,2760,482,2199,561,45000.0,0.173
30251,2012,8184,400,3346,2754,592,2235,519,42561.0,0.155
30251,2013,7810,351,3434,2865,569,2286,579,43695.0,0.169
30251,2014,7568,424,3345,2691,654,2059,632,36866.0,0.189
30251,2015,7264,389,3312,2718,594,2005,713,36565.0,0.215
30251,2016,7016,366,3219,2633,586,1934,699,35777.0,0.217
30251,2017,6911,452,3255,2699,556,2079,620,38542.0,0.19
30251,2018,7294,581,3182,2736,446,2054,682,37452.0,0.214
30251,2019,7721,598,3368,2868,500,2140,728,42500.0,0.216
30252,2010,88700,12608,32113,28916,3197,24352,4564,69911.6,0.142
30252,2011,92903,13691,33032,29993,3039,24976,5017,70770.4,0.152
30252,2012,93723,13618,33267,30273,2994,24560,5713,69908.1,0.172
30252,2013,93894,14524,33462,30614,2848,24629,5985,66249.2,0.179
30252,2014,94784,14980,33625,30763,2862,24201,6562,64575.0,0.195
30252,2015,94271,14853,33222,30353,2869,23797,6556,63714.4,0.197
30252,2016,95039,15574,33320,30545,2775,24005,6540,65457.1,0.196
30252,2017,96186,16393,33858,31061,2797,24344,6717,69101.9,0.198
30252,2018,99468,17433,34766,32141,2625,25004,7137,72707.3,0.205
30252,2019,101726,17880,35233,33017,2216,25433,7584,77946.9,0.215
30253,2010,91220,14313,34930,31262,3668,24371,6891,64583.18,0.197
30253,2011,95053,15283,35894,32286,3608,24585,7701,66312.18,0.215
30253,2012,97244,15141,36457,32757,3700,24071,8686,64447.55,0.238
30253,2013,99288,16107,36932,33288,3644,23986,9302,62059.73,0.252
30253,2014,101576,16004,37174,33731,3443,23593,10138,60492.36,0.273
30253,2015,101955,16551,37612,34061,3551,23529,10532,59764.0,0.28
30253,2016,101564,17477,37477,34054,3423,23495,10559,61751.09,0.282
30253,2017,103084,18133,38068,34954,3114,23844,11110,65227.55,0.292
30253,2018,105891,18982,38894,35819,3075,24254,11565,69174.91,0.297
30253,2019,107623,20065,39708,36823,2885,24783,12040,73429.0,0.303
30256,2010,28777,2848,12811,10784,2027,7889,2895,44710.5,0.226
30256,2011,29047,2632,12759,10632,2127,7769,2863,45585.83,0.224
30256,2012,29722,3048,13097,10842,2255,7935,2907,45735.0,0.222
30256,2013,29833,3064,12952,10657,2295,7755,2902,45137.0,0.224
30256,2014,28834,3103,12688,10340,2348,7480,2860,43083.33,0.225
30256,2015,29579,3100,12700,10478,2222,7420,3058,43930.33,0.241
30256,2016,29516,3326,12464,10464,2000,7297,3167,45685.33,0.254
30256,2017,28864,3340,12320,10398,1922,7103,3295,46933.5,0.267
30256,2018,29470,3422,12715,10843,1872,7259,3584,50621.33,0.282
30256,2019,30252,3426,13125,11433,1692,7608,3825,54731.67,0.291
30257,2010,33223,3099,14184,11939,2245,9015,2924,45258.86,0.206
30257,2011,34091,3873,14655,12222,2433,9437,2785,46695.43,0.19
30257,2012,33854,3982,14729,12403,2326,9673,2730,46102.71,0.185
30257,2013,34813,4285,14966,12834,2132,10060,2774,45960.71,0.185
30257,2014,35085,4450,15197,12929,2268,10103,2826,45918.71,0.186
30257,2015,35201,4551,15259,12982,2277,10231,2751,46929.57,0.18
30257,2016,35047,4496,15098,12995,2103,10138,2857,44650.0,0.189
30257,2017,35608,4845,15347,13188,2159,10086,3102,48768.14,0.202
30257,2018,35703,4672,15520,13241,2279,10215,3026,52008.0,0.195
30257,2019,36125,4829,15672,13423,2249,10499,2924,56094.57,0.187
30258,2010,44754,6073,18565,16135,2430,12076,4059,45947.25,0.219
30258,2011,44565,6122,18714,15946,2768,12182,3764,50225.25,0.201
30258,2012,45904,6159,18970,16337,2633,12247,4090,49719.12,0.216
30258,2013,45321,5849,18464,15823,2641,11785,4038,50068.5,0.219
30258,2014,44735,5776,18350,15389,2961,11645,3744,48802.5,0.204
30258,2015,44423,5717,18583,15555,3028,11680,3875,50049.88,0.209
30258,2016,44517,5730,18200,15663,2537,11378,4285,50035.12,0.235
30258,2017,44773,6218,18337,15704,2633,11533,4171,52678.38,0.227
30258,2018,45091,6060,18678,16000,2678,11574,4426,56391.88,0.237
30258,2019,45370,6040,18819,16510,2309,11765,4745,61837.88,0.252
30259,2010,18238,1234,6977,6253,724,5126,1127,50056.0,0.162
30259,2011,18685,1383,7128,6298,830,5116,1182,47558.67,0.166
30259,2012,19017,1527,7325,6478,847,5267,1211,45482.33,0.165
30259,2013,18182,1576,7416,6596,820,5323,1273,46579.33,0.172
30259,2014,17757,1568,7360,6367,993,4953,1414,45543.0,0.192
30259,2015,17285,1394,7277,6388,889,4883,1505,46654.33,0.207
30259,2016,16903,1362,7227,6326,901,4804,1522,48961.67,0.211
30259,2017,16581,1428,7213,6338,875,4846,1492,50237.67,0.207
30259,2018,17122,1639,7257,6478,779,4831,1647,52961.67,0.227
30259,2019,17813,1873,7447,6629,818,5085,1544,61250.67,0.207
30260,2010,63917,6099,25473,21164,4309,12124,9040,42137.73,0.355
30260,2011,64766,6384,25158,21031,4127,12040,8991,41343.09,0.357
30260,2012,65053,6404,25170,21199,3971,11497,9702,41395.91,0.385
30260,2013,64548,7041,25296,21405,3891,10914,10491,39241.91,0.415
30260,2014,64455,6765,25602,21925,3677,11082,10843,39123.18,0.424
30260,2015,65267,6723,25671,21988,3683,10913,11075,40400.18,0.431
30260,2016,65286,6616,25990,22279,3711,10563,11716,41399.36,0.451
30260,2017,65690,6962,25936,22134,3802,10341,11793,43643.73,0.455
30260,2018,66421,6979,25525,21972,3553,10280,11692,45085.27,0.458
30260,2019,67744,7528,25429,22072,3357,9907,12165,47704.64,0.478
30261,2010,8922,1953,4265,3530,735,2293,1237,49798.0,0.29
30261,2011,8630,1817,4319,3542,777,2215,1327,45914.0,0.307
30261,2012,8806,1633,4010,3300,710,1934,1366,44966.0,0.341
30261,2013,8693,1498,3829,3147,682,1725,1422,41764.0,0.371
30261,2014,9015,1644,3907,3382,525,1961,1421,45934.0,0.364
30261,2015,9323,1564,3842,3448,394,2038,1410,46966.0,0.367
30261,2016,9131,1525,3807,3501,306,2073,1428,49448.0,0.375
30261,2017,8610,1543,3654,3343,311,2015,1328,50615.0,0.363
30261,2018,9005,1815,3859,3565,294,2217,1348,54334.0,0.349
30261,2019,8892,1722,3765,3457,308,2041,1416,53471.0,0.376
30263,2010,88845,11791,37619,32924,4695,23236,9688,54684.6,0.258
30263,2011,91301,12218,38295,33593,4702,23603,9990,54535.33,0.261
30263,2012,93085,12503,38216,34247,3969,23975,10272,54929.13,0.269
30263,2013,94043,12962,38517,34514,4003,24524,9990,55676.0,0.259
30263,2014,95587,13184,38976,35003,3973,24672,10331,57222.2,0.265
30263,2015,97709,14091,39430,36025,3405,25104,10921,57090.27,0.277
30263,2016,99354,15058,39990,36656,3334,25705,10951,58498.53,0.274
30263,2017,101041,16158,40904,37472,3432,25854,11618,60738.33,0.284
30263,2018,102846,16760,41581,38032,3549,26209,11823,63614.0,0.284
30263,2019,105201,17495,42204,38793,3411,27115,11678,68115.87,0.277
30264,2010,6391,512,3105,2417,688,933,1484,27455.0,0.478
30264,2011,6702,421,3088,2538,550,909,1629,30140.0,0.528
30264,2012,6502,349,2969,2527,442,1003,1524,31160.0,0.513
30264,2013,6851,339,3006,2554,452,1157,1397,32725.0,0.465
30264,2014,7414,366,3071,2822,249,1112,1710,33656.0,0.557
30264,2015,7498,524,3104,2953,151,1243,1710,33813.0,0.551
30264,2016,7682,617,3119,2899,220,1237,1662,34503.0,0.533
30264,2017,8360,895,3414,3227,187,1233,1994,34161.0,0.584
30264,2018,8755,1034,3540,3322,218,1274,2048,34432.0,0.579
30264,2019,8494,1104,3459,3238,221,1284,1954,42679.0,0.565
30265,2010,67471,13020,26265,24350,1915,18723,5627,68930.64,0.214
30265,2011,69269,13913,26907,25033,1874,19228,5805,67389.55,0.216
30265,2012,70594,14089,27408,25685,1723,19175,6510,68119.82,0.238
30265,2013,72287,14600,27665,26143,1522,19568,6575,70376.0,0.238
30265,2014,73972,14937,27979,26611,1368,19989,6622,70906.91,0.237
30265,2015,74866,15433,28317,27082,1235,19880,7202,71088.64,0.254
30265,2016,76052,15944,28620,27459,1161,19825,7634,75762.45,0.267
30265,2017,77617,16868,29306,28207,1099,20579,7628,77660.18,0.26
30265,2018,78120,17410,29507,28456,1051,20593,7863,80385.64,0.266
30265,2019,79496,17903,30018,28804,1214,20851,7953,85410.55,0.265
30266,2010,5456,407,2167,1880,287,1525,355,45136.0,0.164
30266,2011,5549,367,2210,1891,319,1518,373,42147.0,0.169
30266,2012,5568,380,2243,1952,291,1627,325,47981.0,0.145
30266,2013,5355,266,2143,1886,257,1632,254,52612.0,0.119
30266,2014,5350,275,2141,1924,217,1603,321,41909.0,0.15
30266,2015,5156,382,2080,1872,208,1597,275,42132.0,0.132
30266,2016,5045,460,2139,1930,209,1559,371,41641.0,0.173
30266,2017,5318,482,2126,1935,191,1490,445,44281.0,0.209
30266,2018,5454,508,2258,2056,202,1513,543,49432.0,0.24
30266,2019,5495,524,2196,2005,191,1551,454,57296.0,0.207
30268,2010,61539,10462,26191,22645,3546,17313,5332,63158.67,0.204
30268,2011,64325,10597,26614,23084,3530,17370,5714,64518.67,0.215
30268,2012,67509,11758,27604,24021,3583,17674,6347,63656.0,0.23
30268,2013,68592,11143,27675,24210,3465,17685,6525,63035.33,0.236
30268,2014,68894,11328,27654,24183,3471,17267,6916,61422.78,0.25
30268,2015,69644,11956,27698,24573,3125,17053,7520,61015.56,0.271
30268,2016,70521,11887,27595,24658,2937,16654,8004,63132.0,0.29
30268,2017,70987,11916,27936,25375,2561,16948,8427,66123.0,0.302
30268,2018,71444,12779,27940,25601,2339,16945,8656,68909.89,0.31
30268,2019,72192,13125,28500,26380,2120,17460,8920,74142.11,0.313
30269,2010,40270,13433,15265,14478,787,11536,2942,97994.29,0.193
30269,2011,40177,13356,15256,14401,855,11338,3063,97693.0,0.201
30269,2012,40313,13574,15272,14242,1030,11093,3149,98067.0,0.206
30269,2013,40267,13877,15471,14387,1084,11022,3365,95571.86,0.218
30269,2014,40852,14269,15680,14607,1073,10892,3715,95992.71,0.237
30269,2015,40470,14419,15448,14447,1001,10704,3743,95429.43,0.242
30269,2016,41288,15541,15669,14770,899,11164,3606,100902.0,0.23
30269,2017,41216,15833,15849,15049,800,11389,3660,104590.14,0.231
30269,2018,41381,16008,16065,15144,921,11587,3557,107217.57,0.221
30269,2019,42006,16287,16404,15498,906,11893,3605,112884.14,0.22
30271,2010,8440,907,3884,3383,501,1056,2327,40022.0,0.599
30271,2011,8835,1017,3892,3451,441,1099,2352,40369.0,0.604
30271,2012,8822,801,3807,3456,351,1054,2402,41078.0,0.631
30271,2013,9274,862,3872,3548,324,1065,2483,37004.0,0.641
30271,2014,9947,990,3887,3595,292,1020,2575,37394.0,0.662
30271,2015,10583,921,4041,3946,95,1165,2781,35135.0,0.688
30271,2016,10536,885,4250,4105,145,1238,2867,37665.0,0.675
30271,2017,11133,1033,4607,4430,177,1327,3103,38792.0,0.674
30271,2018,11079,1222,4781,4528,253,1512,3016,40343.0,0.631
30271,2019,11332,1110,4872,4635,237,1670,2965,41199.0,0.609
30272,2010,11265,1742,4385,3709,676,2177,1532,39583.0,0.349
30272,2011,10330,1711,4570,3788,782,2242,1546,36936.0,0.338
30272,2012,10945,2027,4723,3830,893,2450,1380,36822.0,0.292
30272,2013,10738,1965,4601,3678,923,2479,1199,38900.5,0.261
30272,2014,10714,2101,4578,3544,1034,2431,1113,37267.5,0.243
30272,2015,10769,2158,4684,3524,1160,2291,1233,43767.0,0.263
30272,2016,10346,2021,4651,3372,1279,2257,1115,45135.0,0.24
30272,2017,10070,1895,4588,3456,1132,2182,1274,46540.0,0.278
30272,2018,10513,1885,4612,3542,1070,1953,1589,44577.5,0.345
30272,2019,10736,2051,4770,3828,942,2208,1620,45153.0,0.34
30273,2010,45970,5897,17851,15697,2154,11700,3997,57231.14,0.224
30273,2011,47241,6061,18069,16088,1981,11870,4218,57304.29,0.233
30273,2012,47107,6151,18192,16098,2094,11484,4614,54643.43,0.254
30273,2013,45968,6636,17932,15948,1984,11035,4913,50762.0,0.274
30273,2014,47465,7149,18033,16155,1878,11235,4920,50968.14,0.273
30273,2015,49469,7730,18301,16481,1820,11231,5250,51757.86,0.287
30273,2016,49149,8325,18213,16337,1876,10994,5343,56204.0,0.293
30273,2017,50667,8332,18323,16569,1754,10845,5724,58026.14,0.312
30273,2018,50422,8565,18531,16700,1831,11209,5491,60484.71,0.296
30273,2019,50481,7276,18539,16790,1749,10655,6135,59364.86,0.331
30274,2010,84036,8269,35039,29054,5985,14441,14613,39879.81,0.417
30274,2011,84423,8320,35168,28606,6562,14021,14585,40008.56,0.415
30274,2012,85177,8499,35430,28736,6694,13700,15036,39834.69,0.424
30274,2013,83001,8349,35486,28536,6950,13147,15389,38302.69,0.434
30274,2014,83938,8280,35232,28650,6582,12637,16013,37619.62,0.455
30274,2015,83733,8378,35266,29394,5872,12352,17042,36956.12,0.483
30274,2016,86018,8891,35350,30207,5143,12015,18192,38110.69,0.515
30274,2017,87277,8994,35354,30759,4595,11713,19046,40666.81,0.539
30274,2018,88832,8803,35263,31171,4092,11767,19404,41898.25,0.55
30274,2019,89813,9383,35371,31729,3642,11946,19783,44429.81,0.559
30275,2010,7004,841,2867,2548,319,1746,802,42244.0,0.28
30275,2011,7030,940,2949,2588,361,1689,899,45968.0,0.305
30275,2012,6730,907,2881,2530,351,1632,898,40726.0,0.312
30275,2013,6701,994,2990,2574,416,1698,876,44712.0,0.293
30275,2014,6619,1052,2973,2588,385,1796,792,50905.0,0.266
30275,2015,6961,1096,3019,2754,265,1846,908,50962.0,0.301
30275,2016,7350,1155,3109,2890,219,1854,1036,49282.0,0.333
30275,2017,7185,1181,3014,2787,227,1837,950,51514.0,0.315
30275,2018,6910,1223,2997,2749,248,1901,848,53617.0,0.283
30275,2019,7489,1336,3090,2756,334,1876,880,54070.0,0.285
30276,2010,33195,5202,12410,11412,998,9966,1446,72243.33,0.117
30276,2011,33864,5377,12626,11598,1028,10042,1556,75107.0,0.123
30276,2012,34313,5582,12979,11830,1149,10076,1754,73175.5,0.135
30276,2013,34438,5962,13105,12037,1068,10211,1826,76936.67,0.139
30276,2014,34455,6257,13143,11930,1213,9977,1953,78306.17,0.149
30276,2015,34426,6629,13084,12044,1040,9971,2073,82416.5,0.158
30276,2016,34790,7105,13186,12165,1021,10125,2040,81268.67,0.155
30276,2017,34657,7341,13161,12240,921,10461,1779,83752.67,0.135
30276,2018,35811,7923,13399,12562,837,10637,1925,86128.0,0.144
30276,2019,37040,8039,13793,12941,852,11096,1845,92846.33,0.134
30277,2010,45235,7533,16979,15961,1018,14379,1582,68870.5,0.093
30277,2011,46710,8327,17423,16456,967,14688,1768,68224.5,0.101
30277,2012,47662,8592,17558,16791,767,14671,2120,67764.38,0.121
30277,2013,48472,8864,17653,17004,649,14969,2035,70404.62,0.115
30277,2014,48817,9134,17894,17185,709,15102,2083,70916.88,0.116
30277,2015,49076,9800,18002,17414,588,14976,2438,71041.38,0.135
30277,2016,49455,10210,18132,17572,560,15060,2512,76148.75,0.139
30277,2017,50084,10450,18264,17754,510,15457,2297,77705.25,0.126
30277,2018,50265,10974,18366,17855,511,15376,2479,79713.12,0.135
30277,2019,51385,11418,18914,18270,644,15752,2518,85216.88,0.133
30281,2010,105390,18867,42927,37819,5108,29303,8516,63172.56,0.198
30281,2011,108463,19369,43499,38695,4804,29385,9310,62630.72,0.214
30281,2012,110726,19872,43975,39251,4724,28714,10537,60966.06,0.24
30281,2013,112180,20667,43736,39033,4703,28409,10624,59242.17,0.243
30281,2014,114082,21200,43914,39351,4563,28751,10600,59344.17,0.241
30281,2015,118243,22447,43994,39960,4034,28629,11331,59375.33,0.258
30281,2016,118542,23100,44360,40110,4250,28428,11682,61837.83,0.263
30281,2017,119406,23561,44806,40872,3934,28702,12170,63879.56,0.272
30281,2018,119584,24031,45048,41100,3948,28823,12277,66912.83,0.273
30281,2019,120414,23603,45424,41870,3554,28427,13443,69465.67,0.296
30284,2010,6247,355,2278,1988,290,1417,571,48382.0,0.251
30284,2011,6627,429,2296,2029,267,1365,664,47324.0,0.289
30284,2012,6295,497,2275,1974,301,1383,591,50294.0,0.26
30284,2013,5695,405,2074,1874,200,1376,498,51509.0,0.24
30284,2014,5296,345,2047,1866,181,1373,493,47538.0,0.241
30284,2015,5788,398,2152,1974,178,1364,610,50429.0,0.283
30284,2016,5705,419,2265,2104,161,1486,618,49434.0,0.273
30284,2017,5796,522,2300,2217,83,1580,637,46712.0,0.277
30284,2018,5521,549,2332,2199,133,1476,723,43047.0,0.31
30284,2019,5314,414,2308,2064,244,1419,645,44548.0,0.279
30285,2010,44594,4374,18886,16152,2734,12091,4061,45493.1,0.215
30285,2011,45040,4551,19048,16205,2843,12132,4073,46382.6,0.214
30285,2012,45445,4842,19420,16407,3013,12332,4075,45754.1,0.21
30285,2013,45548,4843,19349,16401,2948,12284,4117,45122.4,0.213
30285,2014,44634,4836,19048,16094,2954,12004,4090,43814.0,0.215
30285,2015,45146,4762,19028,16186,2842,11943,4243,44744.0,0.223
30285,2016,45140,4673,18776,16164,2612,11815,4349,44801.2,0.232
30285,2017,44740,4793,18685,16194,2491,11615,4579,47760.2,0.245
30285,2018,46055,4960,19244,16757,2487,11921,4836,51677.1,0.251
30285,2019,46587,5128,19621,17255,2366,12286,4969,56324.9,0.253
30286,2010,58210,6831,24503,21091,3412,15936,5155,45041.58,0.21
30286,2011,58505,7303,24701,21095,3606,16267,4828,47494.33,0.195
30286,2012,59750,7177,25145,21485,3660,16465,5020,46901.17,0.2
30286,2013,59546,7014,24909,21348,3561,16295,5053,47023.25,0.203
30286,2014,58907,6953,24799,21027,3772,16085,4942,47481.58,0.199
30286,2015,58965,6810,24947,21179,3768,15976,5203,48491.25,0.209
30286,2016,59162,6534,24709,21290,3419,15821,5469,47861.5,0.221
30286,2017,59350,6977,24821,21411,3410,15889,5522,51178.75,0.222
30286,2018,60162,7024,25363,21784,3579,16099,5685,54428.17,0.224
30286,2019,60996,7480,25678,22395,3283,16604,5791,59885.67,0.226
30287,2010,4952,509,2191,1758,433,452,1306,38514.0,0.596
30287,2011,4079,395,2152,1628,524,353,1275,34075.0,0.592
30287,2012,4169,381,2153,1611,542,335,1276,30329.0,0.593
30287,2013,4285,399,2158,1699,459,324,1375,23364.0,0.637
30287,2014,4410,319,2210,1761,449,356,1405,25625.0,0.636
30287,2015,4611,315,2237,1768,469,423,1345,31824.0,0.601
30287,2016,4946,349,2225,1829,396,406,1423,32188.0,0.64
30287,2017,5366,354,2236,1926,310,372,1554,35128.0,0.695
30287,2018,5489,389,2277,1935,342,348,1587,37326.0,0.697
30287,2019,5850,409,2291,1957,334,315,1642,40231.0,0.717
30288,2010,28403,2897,10616,9164,1452,6219,2945,47412.75,0.277
30288,2011,28843,2703,10692,9115,1577,6474,2641,48221.5,0.247
30288,2012,28748,2553,10725,9029,1696,6263,2766,44361.75,0.258
30288,2013,28091,2730,10647,8829,1818,6336,2493,43581.25,0.234
30288,2014,27568,3030,10607,8696,1911,6151,2545,44523.75,0.24
30288,2015,27072,3219,10567,8425,2142,6225,2200,47617.0,0.208
30288,2016,27002,3794,10720,8642,2078,6282,2360,52054.25,0.22
30288,2017,27379,3901,10813,8868,1945,6244,2624,54345.75,0.243
30288,2018,26733,4087,10816,9034,1782,6350,2684,57446.5,0.248
30288,2019,26880,4170,10940,9211,1729,6091,3120,58243.75,0.285
30289,2010,6348,1097,2514,2306,208,1953,353,62081.0,0.14
30289,2011,6414,1064,2422,2235,187,1895,340,64127.0,0.14
30289,2012,6594,1038,2359,2250,109,1807,443,64640.0,0.188
30289,2013,6335,1053,2393,2280,113,1928,352,63905.0,0.147
30289,2014,6424,1089,2521,2326,195,1943,383,68929.0,0.152
30289,2015,6913,1339,2522,2407,115,2001,406,72823.0,0.161
30289,2016,7257,1432,2764,2601,163,2229,372,74250.0,0.135
30289,2017,7133,1369,2729,2582,147,2220,362,71458.0,0.133
30289,2018,7403,1524,2723,2587,136,2185,402,72934.0,0.148
30289,2019,7498,1601,2809,2690,119,2291,399,77542.0,0.142
30290,2010,22532,6542,8413,7858,555,6290,1568,87367.75,0.186
30290,2011,23311,6775,8542,7954,588,6271,1683,87834.0,0.197
30290,2012,23146,6555,8468,7764,704,6060,1704,87499.0,0.201
30290,2013,22838,6717,8384,7726,658,6032,1694,85199.0,0.202
30290,2014,23423,6851,8468,7887,581,6128,1759,88154.5,0.208
30290,2015,23712,7330,8586,8109,477,6259,1850,89500.5,0.215
30290,2016,22920,7362,8459,7829,630,6047,1782,90958.25,0.211
30290,2017,23202,7583,8740,8128,612,6349,1779,93266.5,0.204
30290,2018,23191,7547,8763,8044,719,6315,1729,92480.25,0.197
30290,2019,22899,8077,8937,8091,846,6520,1571,98923.75,0.176
30291,2010,55124,8837,23810,20042,3768,12514,7528,47304.67,0.316
30291,2011,56623,8908,24234,20573,3661,12731,7842,46442.0,0.324
30291,2012,59989,10086,25003,21217,3786,13365,7852,46552.67,0.314
30291,2013,60189,9263,25519,21615,3904,13418,8197,44860.5,0.321
30291,2014,60936,9635,25211,21454,3757,12878,8576,43888.0,0.34
30291,2015,60468,10095,25248,21555,3693,12270,9285,43012.0,0.368
30291,2016,61540,10262,25431,21701,3730,11886,9815,43786.67,0.386
30291,2017,61336,9501,26042,22531,3511,11576,10955,45242.17,0.421
30291,2018,63783,10366,25743,22890,2853,11639,11251,47521.83,0.437
30291,2019,63870,10519,25640,22982,2658,11624,11358,52559.33,0.443
30292,2010,62013,6447,25036,22034,3002,16014,6020,45790.85,0.24
30292,2011,62296,7073,25660,22292,3368,16324,5968,47168.46,0.233
30292,2012,62844,7378,25728,22646,3082,16539,6107,47243.31,0.237
30292,2013,63833,7618,25685,22724,2961,16672,6052,47962.0,0.236
30292,2014,64007,7396,25666,22569,3097,16580,5989,47457.23,0.233
30292,2015,62772,7250,25659,22399,3260,16512,5887,48363.92,0.229
30292,2016,62867,7022,25531,22507,3024,16560,5947,48390.77,0.233
30292,2017,62757,7384,25930,22783,3147,16531,6252,51157.15,0.241
30292,2018,63674,7026,25825,22917,2908,16732,6185,52998.15,0.239
30292,2019,63813,8057,26094,23122,2972,16952,6170,57361.62,0.236
30293,2010,22425,1453,9993,8453,1540,6125,2328,37954.0,0.233
30293,2011,22213,1375,9981,8183,1798,5716,2467,38240.0,0.247
30293,2012,21966,1468,9980,8081,1899,5806,2275,37926.5,0.228
30293,2013,21695,1325,9930,8135,1795,5687,2448,37218.5,0.247
30293,2014,21434,1375,9936,8083,1853,5407,2676,36357.25,0.269
30293,2015,21297,1367,9925,7943,1982,5289,2654,35799.75,0.267
30293,2016,21195,1492,9879,7982,1897,5325,2657,35238.25,0.269
30293,2017,21152,1570,9980,8108,1872,5533,2575,36040.5,0.258
30293,2018,21113,1692,9981,8151,1830,5470,2681,35558.0,0.269
30293,2019,21106,1541,9997,8051,1946,5514,2537,37518.0,0.254
30294,2010,90602,13959,35509,30885,4624,24147,6738,56797.15,0.19
30294,2011,92191,14978,36200,31657,4543,24759,6898,56851.08,0.191
30294,2012,93793,14747,36411,31837,4574,24630,7207,55539.92,0.198
30294,2013,94362,16545,36474,31968,4506,24505,7463,55411.0,0.205
30294,2014,95156,17135,36663,31926,4737,24287,7639,54770.15,0.208
30294,2015,99081,18718,37081,32742,4339,24649,8093,56531.38,0.218
30294,2016,99195,18884,37352,32954,4398,23753,9201,58981.54,0.246
30294,2017,98609,18485,37034,32705,4329,22979,9726,60646.46,0.263
30294,2018,99506,18523,37477,33322,4155,23688,9634,63315.46,0.257
30294,2019,98809,17875,37800,33785,4015,23425,10360,62995.62,0.274
30295,2010,65977,7360,28195,23969,4226,18131,5838,46010.46,0.207
30295,2011,66955,8047,28715,24102,4613,18567,5535,48133.69,0.193
30295,2012,67885,8301,29104,24633,4471,18913,5720,47657.54,0.197
30295,2013,68669,8435,29020,24720,4300,18986,5734,47592.15,0.198
30295,2014,68355,8549,29096,24438,4658,18827,5611,47207.54,0.193
30295,2015,68683,8654,29319,24680,4639,18968,5712,47987.23,0.195
30295,2016,68518,8731,28838,24743,4095,18654,6089,47200.62,0.211
30295,2017,69031,9392,29058,24928,4130,18612,6316,50625.62,0.217
30295,2018,69351,9218,29543,25248,4295,18794,6454,53929.08,0.218
30295,2019,70285,9404,29962,25998,3964,19374,6624,58221.38,0.221
30296,2010,46393,7122,19476,16335,3141,11346,4989,48644.67,0.256
30296,2011,47994,7203,19860,16427,3433,11230,5197,47038.33,0.262
30296,2012,49240,7110,20104,16771,3333,11051,5720,47450.67,0.285
30296,2013,49944,6837,20106,16779,3327,10707,6072,47765.89,0.302
30296,2014,51167,6854,19818,16695,3123,10385,6310,48232.0,0.318
30296,2015,50638,6308,19895,16950,2945,10138,6812,46370.78,0.342
30296,2016,51818,6760,19972,17280,2692,9922,7358,46788.56,0.368
30296,2017,52277,6790,19928,17325,2603,9675,7650,47968.44,0.384
30296,2018,51633,7136,19854,17285,2569,9769,7516,48894.0,0.379
30296,2019,51174,7422,19926,17691,2235,10116,7575,53014.67,0.38
30297,2010,50779,2560,19816,15898,3918,7826,8072,34140.64,0.407
30297,2011,50975,2649,19611,15485,4126,7733,7752,32899.27,0.395
30297,2012,50411,2754,19331,15324,4007,7340,7984,32183.73,0.413
30297,2013,49886,2754,19457,15284,4173,7554,7730,33367.18,0.397
30297,2014,50265,2801,19222,15225,3997,7159,8066,32274.82,0.42
30297,2015,50071,3047,19191,15259,3932,7170,8089,32826.91,0.421
30297,2016,50247,3681,19514,15960,3554,7362,8598,34797.36,0.441
30297,2017,51094,3604,20028,16537,3491,7545,8992,36996.18,0.449
30297,2018,51813,3688,19640,16832,2808,7349,9483,38303.82,0.483
30297,2019,52611,3926,19847,17380,2467,7038,10342,39676.64,0.521
30298,2010,7637,387,2707,2229,478,1083,1146,33782.0,0.423
30298,2011,7959,331,2700,2102,598,1113,989,37628.0,0.366
30298,2012,6952,305,2734,1982,752,1001,981,27028.0,0.359
30298,2013,7271,312,2763,2040,723,1187,853,28264.0,0.309
30298,2014,7140,331,2662,1996,666,1103,893,29477.0,0.335
30298,2015,6355,408,2582,1822,760,1046,776,29860.0,0.301
30298,2016,6396,608,2679,1971,708,1188,783,32820.0,0.292
30298,2017,6782,619,2730,2211,519,1269,942,37236.0,0.345
30298,2018,6467,517,2673,2236,437,1218,1018,35743.0,0.381
30298,2019,6666,524,2726,2417,309,1179,1238,38023.0,0.454
30301,2010,1814,509,1532,1120,412,320,800,30000.0,0.522
30301,2011,2227,580,1543,1108,435,296,812,31774.0,0.526
30301,2012,2031,658,1535,1120,415,244,876,30916.0,0.571
30301,2013,2560,638,1738,1417,321,194,1223,23791.0,0.704
30301,2014,2741,726,1890,1548,342,159,1389,24083.0,0.735
30301,2015,3166,820,1987,1720,267,182,1538,28207.0,0.774
30301,2016,3245,874,2001,1777,224,181,1596,23185.0,0.798
30301,2017,3289,880,2116,1842,274,261,1581,26032.0,0.747
30301,2018,3334,982,2140,1814,326,301,1513,29375.0,0.707
30301,2019,3517,993,2169,1835,334,352,1483,25699.0,0.684
30302,2010,2618,427,1534,1218,316,459,759,21597.0,0.495
30302,2011,2578,427,1501,1149,352,436,713,20750.0,0.475
30302,2012,2616,393,1529,1186,343,376,810,16941.0,0.53
30302,2013,2455,362,1529,1162,367,372,790,12475.0,0.517
30302,2014,2741,287,1553,1184,369,312,872,12333.0,0.561
30302,2015,2769,250,1582,1199,383,286,913,17558.0,0.577
30302,2016,2882,327,1572,1213,359,263,950,19841.0,0.604
30302,2017,2850,372,1574,1259,315,326,933,28902.0,0.593
30302,2018,3019,457,1629,1293,336,280,1013,23711.0,0.622
30302,2019,3311,565,1645,1383,262,293,1090,27188.0,0.663
30303,2010,20427,4882,13215,9966,3249,2713,7253,27972.33,0.549
30303,2011,22008,5186,13183,9969,3214,2856,7113,29181.78,0.54
30303,2012,22508,4893,13352,9992,3360,2552,7440,28056.33,0.557
30303,2013,24639,5371,13597,10514,3083,2617,7897,29505.78,0.581
30303,2014,26780,5774,13962,10984,2978,2520,8464,30419.33,0.606
30303,2015,29519,6358,14120,11614,2506,2734,8880,32452.0,0.629
30303,2016,30402,6695,14272,11867,2405,2573,9294,33093.22,0.651
30303,2017,29923,7029,14492,12090,2402,3012,9078,37984.89,0.626
30303,2018,29653,7014,14698,12151,2547,2891,9260,37714.56,0.63
30303,2019,30734,7543,14998,12627,2371,3401,9226,42996.33,0.615
30304,2010,6103,454,3038,2549,489,847,1702,24599.0,0.56
30304,2011,6175,439,3097,2551,546,873,1678,26216.0,0.542
30304,2012,7152,502,3113,2640,473,788,1852,23816.0,0.595
30304,2013,7555,528,3127,2596,531,752,1844,23933.0,0.59
30304,2014,7922,559,3148,2671,477,724,1947,22982.0,0.618
30304,2015,7952,508,3141,2711,430,638,2073,22329.0,0.66
30304,2016,7995,507,3163,2725,438,638,2087,22180.0,0.66
30304,2017,7880,524,3276,2877,399,745,2132,24465.0,0.651
30304,2018,7513,606,3355,2875,480,624,2251,26369.0,0.671
30304,2019,6824,824,3343,2891,452,810,2081,32044.0,0.622
30305,2010,43844,25415,26703,22064,4639,13205,8859,101923.64,0.332
30305,2011,43149,25520,26763,21689,5074,12742,8947,100457.0,0.334
30305,2012,42926,25530,26294,21456,4838,12720,8736,99890.64,0.332
30305,2013,44109,26184,26098,21419,4679,12872,8547,103729.27,0.327
30305,2014,44692,26163,26284,21600,4684,12844,8756,102219.09,0.333
30305,2015,46349,27618,26515,22088,4427,13527,8561,105525.27,0.323
30305,2016,47801,27789,26924,23064,3860,13859,9205,104267.55,0.342
30305,2017,48761,28315,27471,23309,4162,13633,9676,109985.55,0.352
30305,2018,48972,28668,28294,23680,4614,13644,10036,113699.27,0.355
30305,2019,50622,29895,29188,24901,4287,13966,10935,121264.55,0.375
30306,2010,50040,26965,28263,24748,3515,12817,11931,79344.21,0.422
30306,2011,49295,27364,28177,24510,3667,12730,11780,81436.21,0.418
30306,2012,48590,26618,27742,24219,3523,12399,11820,82809.5,0.426
30306,2013,49674,26709,27519,24472,3047,12317,12155,83333.14,0.442
30306,2014,50383,27788,27736,24637,3099,12354,12283,81784.79,0.443
30306,2015,51040,28790,27984,25101,2883,12469,12632,87212.36,0.451
30306,2016,51195,29058,28031,25116,2915,12292,12824,89436.64,0.457
30306,2017,53057,30541,28127,25159,2968,12515,12644,94846.29,0.45
30306,2018,52672,31905,28280,25283,2997,12790,12493,102021.64,0.442
30306,2019,53555,33105,28419,25699,2720,12861,12838,108139.64,0.452
30307,2010,37735,17012,18799,15978,2821,8652,7326,67365.58,0.39
30307,2011,37482,17014,18625,15843,2782,8386,7457,67231.25,0.4
30307,2012,37256,17453,18437,15929,2508,8365,7564,69189.67,0.41
30307,2013,36975,17110,18307,15853,2454,8031,7822,68295.08,0.427
30307,2014,38264,18241,18507,16200,2307,8187,8013,71472.83,0.433
30307,2015,38529,18566,18781,16658,2123,8156,8502,71458.83,0.453
30307,2016,39163,18643,19105,16945,2160,8170,8775,72185.08,0.459
30307,2017,40216,19640,19303,16883,2420,8452,8431,77110.33,0.437
30307,2018,40750,20226,19550,17100,2450,8818,8282,84847.42,0.424
30307,2019,41362,20891,19504,17246,2258,9113,8133,92085.58,0.417
30308,2010,29990,12610,20296,16403,3893,5952,10451,45615.6,0.515
30308,2011,31111,13329,20609,16704,3905,6191,10513,46565.6,0.51
30308,2012,31267,12899,20476,16411,4065,5874,10537,46237.8,0.515
30308,2013,33515,13754,20406,16842,3564,5839,11003,47561.9,0.539
30308,2014,34954,14364,20750,17312,3438,5986,11326,49370.1,0.546
30308,2015,37920,15701,21114,18052,3062,6256,11796,52995.0,0.559
30308,2016,38438,15969,21408,18482,2926,6146,12336,54851.6,0.576
30308,2017,39455,17184,21937,18901,3036,6413,12488,61611.3,0.569
30308,2018,39838,17889,22644,19350,3294,6447,12903,64603.8,0.57
30308,2019,41299,19652,23446,20387,3059,6942,13445,74649.5,0.573
30309,2010,55119,31100,37416,31386,6030,15146,16240,72931.14,0.434
30309,2011,55878,32029,37706,31341,6365,15104,16237,73132.07,0.431
30309,2012,56407,32828,37668,31618,6050,15102,16516,74224.5,0.438
30309,2013,57680,33171,37706,31479,6227,14764,16715,74777.86,0.443
30309,2014,59860,33801,38786,32441,6345,14846,17595,75265.79,0.454
30309,2015,62473,35783,39617,33348,6269,15086,18262,79366.29,0.461
30309,2016,62375,36455,39971,33943,6028,15353,18590,79455.86,0.465
30309,2017,63405,36532,40757,33919,6838,15328,18591,84693.79,0.456
30309,2018,66059,38439,42360,35518,6842,16296,19222,91205.5,0.454
30309,2019,69036,40687,43703,37338,6365,16889,20449,98784.5,0.468
30310,2010,52299,5666,29268,21234,8034,8419,12815,24421.81,0.438
30310,2011,52785,6224,29426,21322,8104,8345,12977,24066.95,0.441
30310,2012,55048,6106,29205,21379,7826,7927,13452,23842.57,0.461
30310,2013,57099,6399,29166,21646,7520,7758,13888,23227.48,0.476
30310,2014,58234,6219,29072,21515,7557,7302,14213,23863.95,0.489
30310,2015,59502,6397,29415,21920,7495,7372,14548,25308.05,0.495
30310,2016,62390,6536,30039,22695,7344,7208,15487,26036.71,0.516
30310,2017,62428,6933,30301,23333,6968,7717,15616,28385.71,0.515
30310,2018,61863,7592,30612,23812,6800,7916,15896,30424.81,0.519
30310,2019,61429,8548,30637,24228,6409,8140,16088,33629.81,0.525
30311,2010,52967,6979,27480,21251,6229,9905,11346,30475.29,0.413
30311,2011,55646,7314,27608,21756,5852,9617,12139,29357.21,0.44
30311,2012,58111,7625,27234,21747,5487,9444,12303,28513.93,0.452
30311,2013,58699,7917,27257,21777,5480,9265,12512,26912.79,0.459
30311,2014,59062,7748,27039,21690,5349,8864,12826,27081.0,0.474
30311,2015,58802,8056,27467,21673,5794,8540,13133,26738.07,0.478
30311,2016,60524,8123,27975,21852,6123,8288,13564,27389.79,0.485
30311,2017,59833,7949,28400,22259,6141,8267,13992,28125.57,0.493
30311,2018,60728,7961,28735,22909,5826,8376,14533,29847.57,0.506
30311,2019,59267,8630,28798,23052,5746,8521,14531,31132.93,0.505
30312,2010,42597,13718,26698,20852,5846,9524,11328,42014.68,0.424
30312,2011,44462,14322,26963,21258,5705,9138,12120,41222.79,0.45
30312,2012,46150,15182,27082,21662,5420,8836,12826,42284.26,0.474
30312,2013,49534,16384,27711,22682,5029,8885,13797,41351.58,0.498
30312,2014,52029,17265,28229,23486,4743,8571,14915,43388.74,0.528
30312,2015,55072,18215,28693,24559,4134,8934,15625,45435.11,0.545
30312,2016,56870,19404,29236,25171,4065,8937,16234,47729.89,0.555
30312,2017,56529,20573,29642,25437,4205,9599,15838,53903.53,0.534
30312,2018,56803,21581,30348,25918,4430,9773,16145,56744.89,0.532
30312,2019,59036,23147,31141,27044,4097,10386,16658,61287.84,0.535
30313,2010,27525,3777,10175,7223,2952,1393,5830,30881.0,0.573
30313,2011,26705,4298,10199,7053,3146,1395,5658,32059.11,0.555
30313,2012,26631,4358,10224,7180,3044,1368,5812,32147.11,0.568
30313,2013,26599,4394,10373,7326,3047,1482,5844,32842.78,0.563
30313,2014,27539,4657,10762,7786,2976,1455,6331,32761.11,0.588
30313,2015,28613,4990,10698,8357,2341,1656,6701,33634.56,0.626
30313,2016,28766,4728,10592,8349,2243,1697,6652,33761.0,0.628
30313,2017,28683,4828,10736,8371,2365,1860,6511,37159.44,0.606
30313,2018,28286,4917,10538,8222,2316,1897,6325,39825.0,0.6
30313,2019,28008,5198,10361,8321,2040,2214,6107,44043.22,0.589
30314,2010,37340,2793,19997,13081,6916,4068,9013,22849.47,0.451
30314,2011,36310,3388,19527,12641,6886,4156,8485,22816.2,0.435
30314,2012,35766,3857,18786,12190,6596,3985,8205,22834.79,0.437
30314,2013,35174,3929,18727,11863,6864,3636,8227,24354.14,0.439
30314,2014,34713,3925,18796,11884,6912,3319,8565,24379.36,0.456
30314,2015,37160,4408,18924,12648,6276,3466,9182,24645.67,0.485
30314,2016,37094,4195,18993,12740,6253,3353,9387,26023.53,0.494
30314,2017,37950,4224,19308,13057,6251,3396,9661,27241.47,0.5
30314,2018,37977,4409,19122,13207,5915,3558,9649,27710.67,0.505
30314,2019,37437,5131,18811,13388,5423,3786,9602,30260.87,0.51
30315,2010,64009,8840,32135,25112,7023,11752,13360,30709.65,0.416
30315,2011,64545,9004,32148,24921,7227,11495,13426,30641.55,0.418
30315,2012,66508,8834,31839,24716,7123,10902,13814,29799.8,0.434
30315,2013,66335,9070,31771,24234,7537,10613,13621,28813.7,0.429
30315,2014,67580,9268,31686,24306,7380,10296,14010,29278.7,0.442
30315,2015,65202,9161,31238,23811,7427,10059,13752,31071.63,0.44
30315,2016,67662,9634,31985,24261,7724,9905,14356,32456.05,0.449
30315,2017,69320,10579,32259,25126,7133,10500,14626,35962.7,0.453
30315,2018,68936,11324,32687,25830,6857,10488,15342,36930.05,0.469
30315,2019,67951,12150,32815,26206,6609,10720,15486,40196.6,0.472
30316,2010,71295,15849,34281,28739,5542,18281,10458,47532.05,0.305
30316,2011,71631,17021,34238,28551,5687,18126,10425,49216.11,0.304
30316,2012,72109,17748,34012,28458,5554,17706,10752,48766.42,0.316
30316,2013,71457,18700,33788,28106,5682,17464,10642,48386.58,0.315
30316,2014,72071,19972,33643,28068,5575,17282,10786,51523.47,0.321
30316,2015,73267,20468,33956,28583,5373,17191,11392,52791.16,0.335
30316,2016,73653,21586,34641,29174,5467,17299,11875,56450.95,0.343
30316,2017,77074,23328,35115,29960,5155,18162,11798,62299.74,0.336
30316,2018,76166,24233,35707,30390,5317,18228,12162,65270.58,0.341
30316,2019,76961,25804,36134,31265,4869,18600,12665,71380.37,0.351
30317,2010,40086,10687,20713,17030,3683,10711,6319,48904.83,0.305
30317,2011,39784,11243,20644,17059,3585,10707,6352,49703.0,0.308
30317,2012,39730,11776,20419,16833,3586,10592,6241,49515.33,0.306
30317,2013,39846,11910,20286,16725,3561,10444,6281,50364.33,0.31
30317,2014,41882,12582,20080,16763,3317,10250,6513,52399.17,0.324
30317,2015,43186,13215,20087,17111,2976,10188,6923,53707.5,0.345
30317,2016,43286,14039,20498,17656,2842,10342,7314,57493.42,0.357
30317,2017,45110,14694,20939,18126,2813,10936,7190,62847.83,0.343
30317,2018,45876,15552,21115,18540,2575,11061,7479,66363.33,0.354
30317,2019,45627,16917,21226,18740,2486,11697,7043,76596.75,0.332
30318,2010,89079,20896,41558,31708,9850,14018,17690,42101.86,0.426
30318,2011,88886,22183,42150,32301,9849,14050,18251,43894.62,0.433
30318,2012,87362,22608,41533,31543,9990,13775,17768,45340.33,0.428
30318,2013,86322,23464,41601,31389,10212,13580,17809,45466.9,0.428
30318,2014,84801,24901,41946,31783,10163,13476,18307,46826.9,0.436
30318,2015,82929,25436,42061,32325,9736,13017,19308,47427.05,0.459
30318,2016,82775,27046,42242,32648,9594,13012,19636,49323.9,0.465
30318,2017,83897,27470,43467,33415,10052,13093,20322,50603.81,0.468
30318,2018,88703,28339,44683,34938,9745,13550,21388,53828.1,0.479
30318,2019,91261,29528,45170,36253,8917,14051,22202,56150.95,0.492
30319,2010,66289,29778,32630,28717,3913,16199,12518,86359.69,0.384
30319,2011,64873,29815,32807,28767,4040,16367,12400,85466.38,0.378
30319,2012,68379,31957,33351,29711,3640,16659,13052,85204.44,0.391
30319,2013,69720,32822,33949,30254,3695,16773,13481,88070.25,0.397
30319,2014,72676,34920,35427,31542,3885,17726,13816,86566.81,0.39
30319,2015,73352,36287,35750,32364,3386,18279,14085,90206.31,0.394
30319,2016,74672,37693,35467,32195,3272,17712,14483,97139.12,0.408
30319,2017,75331,37539,35964,32105,3859,17832,14273,102220.81,0.397
30319,2018,76381,39721,37432,33401,4031,19252,14149,107215.5,0.378
30319,2019,79588,42328,38663,35128,3535,19755,15373,110451.75,0.398
30321,2010,1871,100,1081,636,445,356,280,32344.0,0.259
30321,2011,1738,132,1055,611,444,356,255,23750.0,0.242
30321,2012,1713,100,1074,623,451,342,281,28702.0,0.262
30321,2013,1842,139,1093,669,424,314,355,22669.0,0.325
30321,2014,1978,146,1070,659,411,322,337,23708.0,0.315
30321,2015,2029,170,1048,693,355,317,376,22332.0,0.359
30321,2016,2090,182,1074,725,349,332,393,24297.0,0.366
30321,2017,2307,188,1088,764,324,305,459,24722.0,0.422
30321,2018,2202,165,1079,718,361,307,411,29808.0,0.381
30321,2019,2136,186,1025,690,335,265,425,27083.0,0.415
30322,2010,9553,3221,2770,2434,336,1525,909,75707.0,0.328
30322,2011,9837,3130,2688,2352,336,1517,835,79238.5,0.311
30322,2012,9626,3149,2626,2303,323,1448,855,78043.0,0.326
30322,2013,9416,2959,2546,2169,377,1361,808,79679.0,0.317
30322,2014,9533,3158,2635,2138,497,1396,742,84584.5,0.282
30322,2015,9708,3339,2718,2266,452,1422,844,85056.0,0.311
30322,2016,9758,3228,2731,2277,454,1337,940,86927.0,0.344
30322,2017,10091,3244,2789,2348,441,1378,970,94990.5,0.348
30322,2018,10687,3342,2887,2471,416,1335,1136,104883.0,0.393
30322,2019,10685,3417,2857,2553,304,1343,1210,103307.0,0.424
30324,2010,44236,19705,25128,22399,2729,9443,12956,64950.3,0.516
30324,2011,44594,20440,25576,22589,2987,9460,13129,67961.4,0.513
30324,2012,46813,21101,26242,23222,3020,9136,14086,70732.9,0.537
30324,2013,48644,21932,26489,23623,2866,9227,14396,69309.3,0.543
30324,2014,49785,22350,27049,23774,3275,9306,14468,69728.1,0.535
30324,2015,49973,23710,27063,24140,2923,9520,14620,71021.1,0.54
30324,2016,49009,23956,26862,23630,3232,9151,14479,74181.8,0.539
30324,2017,50153,24760,26934,23706,3228,9463,14243,79451.7,0.529
30324,2018,50740,25883,27531,24358,3173,9635,14723,86688.7,0.535
30324,2019,51754,27680,27755,25075,2680,9964,15111,91563.3,0.544
30325,2010,3797,2361,1793,1585,208,1127,458,125893.0,0.255
30325,2011,4045,2456,1946,1699,247,1151,548,113878.0,0.282
30325,2012,4318,2524,1991,1673,318,1125,548,115110.0,0.275
30325,2013,4346,2545,1995,1700,295,1112,588,103387.0,0.295
30325,2014,4698,2688,2053,1842,211,1183,659,104038.0,0.321
30325,2015,4948,2734,2069,1932,137,1206,726,101818.0,0.351
30325,2016,5146,2877,2097,2004,93,1243,761,104459.0,0.363
30325,2017,5248,3037,2101,2092,9,1202,890,105197.0,0.424
30325,2018,5300,3087,2260,2173,87,1126,1047,109388.0,0.463
30325,2019,5341,3157,2337,2249,88,1076,1173,111146.0,0.502
30326,2010,20131,10685,11269,9614,1655,6060,3554,98392.0,0.315
30326,2011,19441,11112,11426,9570,1856,5956,3614,101569.25,0.316
30326,2012,20360,11727,11547,10018,1529,6026,3992,101395.0,0.346
30326,2013,20950,12019,11919,10255,1664,6185,4070,107807.0,0.341
30326,2014,21303,12460,12385,10607,1778,6288,4319,103899.0,0.349
30326,2015,21849,13250,12651,10864,1787,6616,4248,108895.5,0.336
30326,2016,23118,13742,13022,11329,1693,6882,4447,106275.5,0.341
30326,2017,23205,13817,13547,11361,2186,6754,4607,107018.75,0.34
30326,2018,23756,14482,14309,11935,2374,7183,4752,107450.5,0.332
30326,2019,25686,15951,15023,12815,2208,7353,5462,116915.25,0.364
30327,2010,50409,25647,25101,22149,2952,13818,8331,110362.64,0.332
30327,2011,50429,26139,24812,21976,2836,13569,8407,111088.0,0.339
30327,2012,50302,25631,24842,21648,3194,13079,8569,109854.82,0.345
30327,2013,51167,26426,24878,21759,3119,13124,8635,111963.36,0.347
30327,2014,51556,27172,25033,21770,3263,13303,8467,113986.55,0.338
30327,2015,52885,28570,25292,22311,2981,13739,8572,113714.0,0.339
30327,2016,54858,29502,25912,22860,3052,13866,8994,118580.82,0.347
30327,2017,55660,30497,26253,23320,2933,13890,9430,117284.36,0.359
30327,2018,56187,31450,27018,23652,3366,14205,9447,126197.18,0.35
30327,2019,57639,32307,27694,24638,3056,14392,10246,128696.27,0.37
30328,2010,45397,20373,23034,20221,2813,12850,7371,85763.8,0.32
30328,2011,46583,20600,22891,20280,2611,12494,7786,83424.0,0.34
30328,2012,47478,20681,23378,20523,2855,12302,8221,80917.4,0.352
30328,2013,48847,21424,23605,20779,2826,12061,8718,80192.2,0.369
30328,2014,50780,22364,23884,21211,2673,12011,9200,80941.9,0.385
30328,2015,51792,22954,24173,21685,2488,12046,9639,81433.9,0.399
30328,2016,54478,25158,24973,22813,2160,12911,9902,87570.1,0.397
30328,2017,55532,25418,25351,23371,1980,13226,10145,91871.6,0.4
30328,2018,56941,26814,25958,24049,1909,14083,9966,95748.4,0.384
30328,2019,58338,27987,26983,25045,1938,14457,10588,97689.9,0.392
30329,2010,56071,18856,25687,22918,2769,8575,14343,50904.54,0.558
30329,2011,56483,18341,26048,22859,3189,8792,14067,52666.69,0.54
30329,2012,56733,18678,26302,23080,3222,8890,14190,52129.77,0.54
30329,2013,56492,18481,26186,22909,3277,8659,14250,53857.08,0.544
30329,2014,56924,18551,26508,22821,3687,8958,13863,55056.15,0.523
30329,2015,58515,19740,26575,23202,3373,8907,14295,58536.31,0.538
30329,2016,59262,20486,26111,23017,3094,8374,14643,62682.92,0.561
30329,2017,59968,21293,26048,23020,3028,8399,14621,67096.08,0.561
30329,2018,59521,21732,26230,23091,3139,8379,14712,71030.46,0.561
30329,2019,60564,22742,26184,23575,2609,8517,15058,75889.0,0.575
30331,2010,101330,19584,46176,38522,7654,22657,15865,40876.44,0.344
30331,2011,107324,21416,47643,39969,7674,23017,16952,41305.44,0.356
30331,2012,110298,22751,48373,40326,8047,23010,17316,40965.61,0.358
30331,2013,113168,23301,48954,40535,8419,22674,17861,40234.78,0.365
30331,2014,115204,24049,48815,41130,7685,22181,18949,39536.67,0.388
30331,2015,118027,25483,49432,41750,7682,21852,19898,39407.67,0.403
30331,2016,120963,25743,50035,42691,7344,21775,20916,38696.78,0.418
30331,2017,123512,25950,50938,43912,7026,22617,21295,39708.94,0.418
30331,2018,124040,26967,51265,44925,6340,23668,21257,41468.44,0.415
30331,2019,127435,29161,52608,46530,6078,24222,22308,43610.0,0.424
30332,2010,11634,991,1192,949,243,287,662,41330.5,0.555
30332,2011,10184,1393,1369,1071,298,350,721,43397.5,0.527
30332,2012,10396,1597,1463,1185,278,351,834,53420.5,0.57
30332,2013,10259,1528,1347,1130,217,363,767,44305.5,0.569
30332,2014,10081,1556,1485,1177,308,413,764,50157.0,0.514
30332,2015,9907,1670,1573,1268,305,408,860,52854.0,0.547
30332,2016,9778,1503,1587,1252,335,398,854,50719.0,0.538
30332,2017,9738,1548,1744,1311,433,408,903,53691.0,0.518
30332,2018,9829,1493,1870,1374,496,405,969,63644.5,0.518
30332,2019,10209,1740,1957,1536,421,455,1081,67444.0,0.552
30333,2010,5610,2678,2875,2531,344,978,1553,55457.0,0.54
30333,2011,5610,2783,2921,2563,358,986,1577,55811.0,0.54
30333,2012,5406,2806,2936,2573,363,977,1596,52257.0,0.544
30333,2013,4954,2736,2904,2486,418,945,1541,57861.0,0.531
30333,2014,4921,2801,2971,2505,466,869,1636,51215.0,0.551
30333,2015,5056,2935,3023,2528,495,876,1652,55580.0,0.546
30333,2016,5115,3114,2960,2556,404,868,1688,60000.0,0.57
30333,2017,5106,3080,2971,2540,431,850,1690,58519.0,0.569
30333,2018,5131,3148,2919,2508,411,885,1623,64438.0,0.556
30333,2019,5357,3126,2833,2514,319,838,1676,77708.0,0.592
30334,2010,4483,988,2434,1938,496,686,1252,37283.0,0.514
30334,2011,4422,911,2331,1783,548,609,1174,35984.0,0.504
30334,2012,4595,906,2394,1878,516,584,1294,35476.5,0.541
30334,2013,4452,911,2342,1800,542,583,1217,34332.5,0.52
30334,2014,4791,797,2291,1777,514,486,1291,33143.0,0.564
30334,2015,4876,793,2322,1809,513,517,1292,34204.0,0.556
30334,2016,5094,902,2320,1844,476,493,1351,36811.0,0.582
30334,2017,5025,922,2287,1821,466,553,1268,42243.5,0.554
30334,2018,5041,1019,2356,1904,452,482,1422,40397.0,0.604
30334,2019,5385,1184,2466,2097,369,539,1558,40538.5,0.632
30336,2010,18568,3393,7949,6580,1369,3608,2972,33694.5,0.374
30336,2011,18489,3455,7791,6475,1316,3493,2982,34873.0,0.383
30336,2012,17894,3639,7801,6356,1445,3435,2921,36077.75,0.374
30336,2013,18134,3928,7854,6334,1520,3465,2869,38348.0,0.365
30336,2014,18466,4192,7830,6469,1361,3526,2943,36458.5,0.376
30336,2015,17889,4135,7851,6315,1536,3252,3063,34154.0,0.39
30336,2016,19095,4264,8064,6681,1383,3590,3091,34563.25,0.383
30336,2017,19775,4248,8240,6906,1334,3875,3031,36457.5,0.368
30336,2018,19815,4418,8348,7067,1281,3964,3103,37604.5,0.372
30336,2019,19998,4728,8442,7238,1204,3983,3255,38530.5,0.386
30337,2010,31712,5291,17581,12884,4697,4972,7912,34702.43,0.45
30337,2011,31706,5341,17418,12880,4538,4897,7983,35289.43,0.458
30337,2012,31881,5185,16874,12521,4353,4726,7795,35137.14,0.462
30337,2013,33188,5047,16595,12534,4061,4581,7953,33240.29,0.479
30337,2014,33581,4971,16423,12558,3865,4373,8185,32484.86,0.498
30337,2015,35275,5443,16809,13243,3566,4529,8714,35035.0,0.518
30337,2016,35637,5722,17394,13660,3734,4560,9100,35327.57,0.523
30337,2017,36321,6042,17430,13935,3495,4561,9374,35736.14,0.538
30337,2018,35414,6165,17512,13997,3515,4458,9539,39999.71,0.545
30337,2019,36097,6666,17649,14201,3448,4715,9486,40600.71,0.537
30338,2010,64089,31063,31907,28589,3318,16717,11872,95392.08,0.372
30338,2011,65286,31770,31541,28532,3009,16407,12125,96825.92,0.384
30338,2012,65944,31365,31956,28618,3338,16003,12615,93864.77,0.395
30338,2013,66571,32874,32219,29082,3137,15952,13130,90422.46,0.408
30338,2014,68180,33435,32353,29105,3248,15978,13127,91040.31,0.406
30338,2015,69639,33830,32554,29515,3039,15943,13572,91116.08,0.417
30338,2016,71300,35865,33539,30116,3423,16057,14059,95727.69,0.419
30338,2017,73241,36873,34022,30523,3499,16164,14359,101215.0,0.422
30338,2018,74810,38015,34683,31180,3503,16926,14254,106881.92,0.411
30338,2019,76468,39468,35609,32452,3157,17696,14756,109572.54,0.414
30339,2010,53660,24819,31187,27207,3980,10538,16669,80255.25,0.534
30339,2011,55322,25946,31746,27838,3908,10663,17175,79700.83,0.541
30339,2012,57359,26152,32425,28483,3942,10806,17677,76772.92,0.545
30339,2013,58499,27030,32840,28999,3841,10934,18065,77626.08,0.55
30339,2014,60569,28150,33202,29896,3306,10994,18902,76428.67,0.569
30339,2015,61782,29072,33417,30170,3247,11278,18892,79200.17,0.565
30339,2016,63516,29920,33893,30705,3188,11879,18826,85794.75,0.555
30339,2017,63528,31078,34132,30784,3348,12259,18525,88889.42,0.543
30339,2018,64530,32475,34857,31159,3698,12460,18699,93751.58,0.536
30339,2019,65564,33775,35430,31695,3735,12859,18836,99723.67,0.532
30340,2010,59001,11931,25013,22046,2967,9338,12708,45139.54,0.508
30340,2011,58605,12144,24213,21271,2942,9331,11940,47075.69,0.493
30340,2012,59578,12021,24562,21490,3072,9245,12245,45476.38,0.499
30340,2013,60987,12426,24483,21513,2970,9048,12465,45286.77,0.509
30340,2014,62107,12018,24479,21392,3087,8897,12495,45522.92,0.51
30340,2015,61083,12115,24123,21193,2930,8755,12438,45217.92,0.516
30340,2016,59665,12683,23679,21014,2665,8718,12296,48035.0,0.519
30340,2017,60723,12945,23401,20916,2485,9075,11841,49592.69,0.506
30340,2018,59299,12839,23300,20997,2303,9101,11896,52037.62,0.511
30340,2019,58143,12892,23372,21371,2001,9202,12169,53391.38,0.521
30341,2010,70958,23416,30965,27705,3260,15929,11776,63118.75,0.38
30341,2011,70646,24225,30783,27541,3242,15761,11780,63940.19,0.383
30341,2012,70688,24689,31870,28162,3708,16114,12048,62882.56,0.378
30341,2013,73457,25515,32723,29042,3681,16339,12703,61881.69,0.388
30341,2014,74805,26441,33766,29684,4082,16378,13306,61147.19,0.394
30341,2015,76085,27371,34338,30431,3907,16544,13887,60300.56,0.404
30341,2016,76166,27854,33580,29857,3723,16063,13794,62616.69,0.411
30341,2017,77963,28320,33305,29821,3484,16221,13600,65904.5,0.408
30341,2018,78322,29753,34013,30781,3232,16778,14003,69156.94,0.412
30341,2019,78156,30491,34124,31192,2932,17180,14012,72177.62,0.411
30342,2010,42225,20122,21189,18526,2663,10591,7935,100648.11,0.374
30342,2011,42813,20387,21124,18492,2632,10400,8092,106636.78,0.383
30342,2012,44142,20857,21123,18722,2401,10205,8517,101261.44,0.403
30342,2013,45690,20775,21260,18927,2333,10079,8848,100246.0,0.416
30342,2014,45224,21218,21658,18984,2674,10233,8751,102571.78,0.404
30342,2015,45889,22796,21858,19240,2618,10775,8465,103083.67,0.387
30342,2016,45174,22328,22231,19287,2944,10618,8669,104490.78,0.39
30342,2017,44860,22621,22824,19444,3380,10510,8934,105701.89,0.391
30342,2018,45516,23692,23338,19869,3469,10871,8998,112103.56,0.386
30342,2019,47304,25136,23817,20780,3037,11055,9725,116031.44,0.408
30343,2010,2074,867,1985,1277,708,225,1052,37406.0,0.53
30343,2011,2595,976,1996,1239,757,259,980,40515.0,0.491
30343,2012,3227,731,2038,1203,835,269,934,37639.0,0.458
30343,2013,3659,846,1949,1178,771,378,800,51098.0,0.41
30343,2014,4361,977,1936,1274,662,387,887,51474.0,0.458
30343,2015,4977,1200,1921,1335,586,460,875,54073.0,0.455
30343,2016,5234,1239,1880,1347,533,451,896,58693.0,0.477
30343,2017,5188,1279,1898,1382,516,472,910,62222.0,0.479
30343,2018,5060,1154,1882,1318,564,464,854,59375.0,0.454
30343,2019,5064,1136,1931,1400,531,541,859,62656.0,0.445
30344,2010,60265,8632,31071,23893,7178,9391,14502,35693.71,0.467
30344,2011,62267,9064,32112,24663,7449,9500,15163,34896.71,0.472
30344,2012,62950,9640,32141,24769,7372,9400,15369,33975.29,0.478
30344,2013,63741,9594,32174,24275,7899,9070,15205,33063.36,0.473
30344,2014,64754,9535,32238,24707,7531,8793,15914,33099.36,0.494
30344,2015,65508,9893,32794,25728,7066,8934,16794,34512.07,0.512
30344,2016,65568,10691,33501,26381,7120,9433,16948,35593.5,0.506
30344,2017,65639,10954,33392,26374,7018,9403,16971,36070.93,0.508
30344,2018,65333,11662,32970,26790,6180,9593,17197,38511.29,0.522
30344,2019,64606,12710,33171,26868,6303,9286,17582,38950.93,0.53
30345,2010,34567,13578,15242,13756,1486,8917,4839,74689.88,0.317
30345,2011,36821,14337,16077,14482,1595,8996,5486,74742.38,0.341
30345,2012,35936,13896,16360,14516,1844,8949,5567,75507.5,0.34
30345,2013,36767,14356,16513,14679,1834,9023,5656,79194.62,0.343
30345,2014,35645,14747,16790,14695,2095,8834,5861,81137.62,0.349
30345,2015,37234,15489,17177,15228,1949,8953,6275,80824.62,0.365
30345,2016,36915,15526,16843,14926,1917,8712,6214,85419.62,0.369
30345,2017,37642,15938,16771,15130,1641,8780,6350,90775.75,0.379
30345,2018,37895,16547,16905,15311,1594,8865,6446,93195.5,0.381
30345,2019,38004,16672,16842,15453,1389,9032,6421,97969.88,0.381
30346,2010,11856,5975,6819,6059,760,1833,4226,67347.5,0.62
30346,2011,12810,6415,7081,6343,738,1984,4359,68624.0,0.616
30346,2012,13053,6557,7218,6301,917,1914,4387,72056.0,0.608
30346,2013,13665,7670,7533,6666,867,1832,4834,75970.5,0.642
30346,2014,14154,7827,7618,6604,1014,1822,4782,77756.0,0.628
30346,2015,14485,7784,7731,6622,1109,1682,4940,80203.0,0.639
30346,2016,14191,8147,8009,6567,1442,1467,5100,88714.5,0.637
30346,2017,14085,8493,8083,6603,1480,1547,5056,91391.5,0.626
30346,2018,14404,8653,7972,6580,1392,1560,5020,98108.0,0.63
30346,2019,14524,8597,7969,6750,1219,1637,5113,93588.0,0.642
30349,2010,127663,21116,57292,47206,10086,28108,19098,46073.65,0.333
30349,2011,133789,22572,58473,48470,10003,28621,19849,46018.05,0.339
30349,2012,136392,23735,59438,48778,10660,29155,19623,44899.25,0.33
30349,2013,137818,22425,59797,49231,10566,29246,19985,43102.35,0.334
30349,2014,141094,23415,59374,49288,10086,28584,20704,41919.3,0.349
30349,2015,142094,25015,59611,49731,9880,27973,21758,41999.05,0.365
30349,2016,142796,25843,60153,49899,10254,27273,22626,42558.35,0.376
30349,2017,146755,25393,61240,51849,9391,27458,24391,44588.65,0.398
30349,2018,150244,26708,60991,52650,8341,27890,24760,46770.85,0.406
30349,2019,151807,27370,61738,54055,7683,28087,25968,49887.15,0.421
30350,2010,63876,26025,31428,27498,3930,13777,13721,86565.4,0.437
30350,2011,63327,25423,30606,27094,3512,13261,13833,83861.53,0.452
30350,2012,63795,25342,30659,27198,3461,12912,14286,82231.13,0.466
30350,2013,64550,25406,30450,27335,3115,12639,14696,77324.8,0.483
30350,2014,66838,26061,30317,27725,2592,12536,15189,77823.33,0.501
30350,2015,68083,27001,30708,28531,2177,13154,15377,78216.93,0.501
30350,2016,69724,28735,31576,29429,2147,13638,15791,82144.2,0.5
30350,2017,72113,29569,32020,29993,2027,13565,16428,87648.53,0.513
30350,2018,72679,30367,32471,30250,2221,13915,16335,93110.33,0.503
30350,2019,72702,31387,32991,30588,2403,14551,16037,96984.93,0.486
30354,2010,45135,3091,19968,15599,4369,6182,9417,29650.9,0.472
30354,2011,45069,3096,20222,15472,4750,6276,9196,29003.9,0.455
30354,2012,44765,3211,19959,15223,4736,5976,9247,29390.3,0.463
30354,2013,45644,3233,20244,15147,5097,5960,9187,28248.2,0.454
30354,2014,46746,3629,19929,15262,4667,5684,9578,28329.2,0.481
30354,2015,45519,3833,19935,15330,4605,5611,9719,29769.2,0.488
30354,2016,46370,4315,20677,16074,4603,5875,10199,29597.1,0.493
30354,2017,48048,4202,20841,16495,4346,5969,10526,30933.1,0.505
30354,2018,47347,4642,20692,16791,3901,5951,10840,34331.3,0.524
30354,2019,46141,4844,20797,17096,3701,5932,11164,33075.6,0.537
30355,2010,3571,1730,2991,2176,815,933,1243,55291.0,0.416
30355,2011,3669,1715,2936,2096,840,879,1217,54034.0,0.415
30355,2012,3635,1754,2882,2023,859,882,1141,56272.0,0.396
30355,2013,3616,1946,2891,2068,823,857,1211,59800.0,0.419
30355,2014,3901,2155,2891,2146,745,856,1290,61908.0,0.446
30355,2015,4194,2467,2966,2294,672,921,1373,62866.0,0.463
30355,2016,4557,2736,3124,2631,493,1048,1583,67063.0,0.507
30355,2017,4401,2748,3326,2691,635,1175,1516,75987.0,0.456
30355,2018,4655,2940,3486,2818,668,1249,1569,82452.0,0.45
30355,2019,4830,3182,3735,3071,664,1279,1792,83243.0,0.48
30356,2010,6365,3265,2200,2150,50,2052,98,123375.0,0.045
30356,2011,6120,3164,2126,2059,67,1919,140,118466.0,0.066
30356,2012,6320,3045,2071,2027,44,1877,150,114345.0,0.072
30356,2013,6224,2973,2074,2038,36,1834,204,105161.0,0.098
30356,2014,6285,2961,2056,2017,39,1837,180,105088.0,0.088
30356,2015,6332,3008,2068,2068,0,1993,75,106843.0,0.036
30356,2016,6193,3202,2110,2110,0,2056,54,116071.0,0.026
30356,2017,6128,3292,2149,2149,0,2106,43,140481.0,0.02
30356,2018,6246,3297,2152,2143,9,2122,21,149803.0,0.01
30356,2019,6206,3316,2190,2181,9,2160,21,172279.0,0.01
30357,2010,1806,823,813,638,175,287,351,52411.0,0.432
30357,2011,1866,1006,916,733,183,350,383,55545.0,0.418
30357,2012,2170,1125,952,786,166,351,435,71216.0,0.457
30357,2013,2346,1153,821,697,124,363,334,64583.0,0.407
30357,2014,2531,1191,917,734,183,410,324,67353.0,0.353
30357,2015,2677,1274,1000,770,230,404,366,75375.0,0.366
30357,2016,2648,1156,1049,782,267,395,387,75556.0,0.369
30357,2017,2740,1211,1163,818,345,401,417,80132.0,0.359
30357,2018,2766,1137,1285,880,405,398,482,95900.0,0.375
30357,2019,2904,1330,1371,1020,351,443,577,103846.0,0.421
30358,2010,4993,2456,2458,2329,129,1942,387,94566.0,0.157
30358,2011,4965,2503,2468,2266,202,1879,387,106635.0,0.157
30358,2012,5069,2513,2494,2225,269,1805,420,87148.0,0.168
30358,2013,4687,2484,2457,2101,356,1691,410,90903.0,0.167
30358,2014,5002,2660,2437,2127,310,1664,463,95703.0,0.19
30358,2015,4978,2676,2412,2075,337,1652,423,97083.0,0.175
30358,2016,5347,2994,2522,2279,243,1849,430,101680.0,0.17
30358,2017,5151,3014,2497,2267,230,1856,411,111103.0,0.165
30358,2018,5350,3044,2553,2532,21,2073,459,101341.0,0.18
30358,2019,5607,3237,2756,2652,104,2052,600,103828.0,0.218
30359,2010,5215,2182,2733,2386,347,1044,1342,50347.0,0.491
30359,2011,5800,2178,2793,2391,402,1072,1319,52825.0,0.472
30359,2012,5345,1837,2807,2304,503,974,1330,53913.0,0.474
30359,2013,5397,1896,2811,2335,476,970,1365,52218.0,0.486
30359,2014,5117,1728,2804,2237,567,991,1246,49044.0,0.444
30359,2015,5524,1777,2725,2258,467,966,1292,56484.0,0.474
30359,2016,5550,1798,2741,2286,455,956,1330,60686.0,0.485
30359,2017,6128,2247,2743,2489,254,945,1544,69509.0,0.563
30359,2018,6169,2458,2755,2463,292,1015,1448,83311.0,0.526
30359,2019,6236,2685,2807,2589,218,1016,1573,82454.0,0.56
30360,2010,35113,8447,16380,14179,2201,5571,8608,52521.38,0.526
30360,2011,34938,8397,15729,13537,2192,5414,8123,51902.75,0.516
30360,2012,35577,8111,15573,13485,2088,5181,8304,51317.12,0.533
30360,2013,35783,8319,15402,13309,2093,5140,8169,50315.0,0.53
30360,2014,36902,8271,15283,13223,2060,5187,8036,52345.38,0.526
30360,2015,37424,8662,15323,13464,1859,5195,8269,52639.62,0.54
30360,2016,37121,9406,15266,13690,1576,5276,8414,55204.38,0.551
30360,2017,38075,9744,15369,13824,1545,5417,8407,59704.38,0.547
30360,2018,38238,10018,15534,14202,1332,5552,8650,62758.38,0.557
30360,2019,38270,10453,15877,14713,1164,5834,8879,64028.38,0.559
30361,2010,1672,1192,1324,1055,269,647,408,100125.0,0.308
30361,2011,1764,1275,1311,1057,254,644,413,106528.0,0.315
30361,2012,1741,1221,1221,998,223,553,445,106136.0,0.364
30361,2013,1659,1141,1207,948,259,544,404,105938.0,0.335
30361,2014,1642,1084,1170,874,296,525,349,92273.0,0.298
30361,2015,1592,1028,1135,813,322,502,311,102560.0,0.274
30361,2016,1757,1081,1144,865,279,557,308,92361.0,0.269
30361,2017,1805,1121,1194,934,260,571,363,91857.0,0.304
30361,2018,1910,1177,1181,998,183,628,370,88971.0,0.313
30361,2019,2047,1237,1222,1019,203,663,356,97257.0,0.291
30362,2010,5959,489,1967,1728,239,812,916,32331.0,0.466
30362,2011,5848,521,1956,1731,225,751,980,34816.0,0.501
30362,2012,5962,527,1944,1759,185,823,936,33891.0,0.481
30362,2013,6141,511,1918,1696,222,703,993,33318.0,0.518
30362,2014,6541,503,1926,1744,182,731,1013,33994.0,0.526
30362,2015,6496,545,1866,1770,96,726,1044,35417.0,0.559
30362,2016,6141,597,1787,1702,85,656,1046,37870.0,0.585
30362,2017,6297,702,1786,1719,67,697,1022,38710.0,0.572
30362,2018,6164,638,1781,1701,80,701,1000,42392.0,0.561
30362,2019,5869,562,1814,1695,119,682,1013,43309.0,0.558
30363,2010,8416,3773,4692,3546,1146,1471,2075,63771.0,0.442
30363,2011,10077,4142,5544,4163,1381,1716,2447,60886.5,0.441
30363,2012,10743,4093,5891,4313,1578,1666,2647,58124.0,0.449
30363,2013,10738,4235,5990,4336,1654,1589,2747,60717.5,0.459
30363,2014,11575,4556,6251,4544,1707,1635,2909,63113.5,0.465
30363,2015,11377,4656,6307,4699,1608,1578,3121,66171.0,0.495
30363,2016,11775,5136,6357,4843,1514,1763,3080,68365.0,0.485
30363,2017,11922,5527,6570,5086,1484,1863,3223,68359.5,0.491
30363,2018,12963,5511,6824,5388,1436,1916,3472,72746.5,0.509
30363,2019,13171,5857,7068,5837,1231,2080,3757,71913.0,0.532
30364,2010,5197,616,2579,1880,699,742,1138,37670.0,0.441
30364,2011,5635,663,2504,1905,599,779,1126,34449.0,0.45
30364,2012,5333,691,2434,1774,660,721,1053,34559.0,0.433
30364,2013,5519,701,2328,1688,640,763,925,34957.0,0.397
30364,2014,5330,683,2316,1648,668,801,847,39922.0,0.366
30364,2015,4870,611,2376,1693,683,746,947,37478.0,0.399
30364,2016,4367,637,2468,1621,847,774,847,40607.0,0.343
30364,2017,4169,697,2437,1608,829,696,912,40150.0,0.374
30364,2018,4169,793,2345,1639,706,659,980,42079.0,0.418
30364,2019,3683,704,2328,1583,745,584,999,44614.0,0.429
30366,2010,2924,1203,1509,1322,187,1012,310,61357.0,0.205
30366,2011,2724,1123,1376,1170,206,852,318,63194.0,0.231
30366,2012,2964,1322,1560,1323,237,971,352,61625.0,0.226
30366,2013,3305,1316,1763,1489,274,990,499,57964.0,0.283
30366,2014,4155,1655,1959,1697,262,1072,625,58935.0,0.319
30366,2015,4032,1658,1932,1710,222,1027,683,57976.0,0.354
30366,2016,4179,1820,1912,1757,155,1020,737,58776.0,0.385
30366,2017,4273,1943,1893,1784,109,1028,756,67850.0,0.399
30366,2018,4460,2134,2071,1900,171,1091,809,72429.0,0.391
30366,2019,4237,2255,2080,1942,138,1161,781,74922.0,0.375
30368,2010,1871,100,1081,636,445,356,280,32344.0,0.259
30368,2011,1738,132,1055,611,444,356,255,23750.0,0.242
30368,2012,1713,100,1074,623,451,342,281,28702.0,0.262
30368,2013,1842,139,1093,669,424,314,355,22669.0,0.325
30368,2014,1978,146,1070,659,411,322,337,23708.0,0.315
30368,2015,2029,170,1048,693,355,317,376,22332.0,0.359
30368,2016,2090,182,1074,725,349,332,393,24297.0,0.366
30368,2017,2307,188,1088,764,324,305,459,24722.0,0.422
30368,2018,2202,165,1079,718,361,307,411,29808.0,0.381
30368,2019,2136,186,1025,690,335,265,425,27083.0,0.415
30369,2010,4304,523,2362,1807,555,664,1143,15893.0,0.484
30369,2011,4714,570,2464,1927,537,682,1245,19152.0,0.505
30369,2012,4787,470,2444,1891,553,604,1287,19310.0,0.527
30369,2013,4349,503,2398,1819,579,484,1335,21699.0,0.557
30369,2014,4235,724,2389,1932,457,494,1438,26279.0,0.602
30369,2015,4364,812,2440,2051,389,536,1515,26998.0,0.621
30369,2016,4235,959,2474,2086,388,551,1535,27395.0,0.62
30369,2017,5178,1113,2633,2362,271,636,1726,29583.0,0.656
30369,2018,5592,999,2759,2519,240,571,1948,33339.0,0.706
30369,2019,5781,911,2785,2562,223,639,1923,33732.0,0.69
30377,2010,9828,168,379,311,68,0,311,30250.0,0.821
30377,2011,8318,387,453,338,115,0,338,31250.0,0.746
30377,2012,8226,472,511,399,112,0,399,35625.0,0.781
30377,2013,7913,375,526,433,93,0,433,24028.0,0.823
30377,2014,7550,365,568,443,125,3,440,32961.0,0.775
30377,2015,7230,396,573,498,75,4,494,30333.0,0.862
30377,2016,7130,347,538,470,68,3,467,25882.0,0.868
30377,2017,6998,337,581,493,88,7,486,27250.0,0.836
30377,2018,7063,356,585,494,91,7,487,31389.0,0.832
30377,2019,7305,410,586,516,70,12,504,31042.0,0.86
30378,2010,8902,2746,3454,3104,350,2262,842,69714.0,0.244
30378,2011,9318,2768,3603,3159,444,2186,973,70961.0,0.27
30378,2012,9247,2864,3749,3260,489,2212,1048,74854.0,0.28
30378,2013,9746,2941,3885,3352,533,2111,1241,71333.0,0.319
30378,2014,10181,3276,4018,3542,476,2279,1263,70352.0,0.314
30378,2015,9494,3097,4107,3462,645,2167,1295,56698.0,0.315
30378,2016,10275,3376,4212,3709,503,2504,1205,61804.0,0.286
30378,2017,10581,3325,4325,3974,351,2826,1148,63209.0,0.265
30378,2018,10933,3562,4383,4036,347,2928,1108,68540.0,0.253
30378,2019,10840,3715,4493,4104,389,2886,1218,71457.0,0.271
30380,2010,1871,100,1081,636,445,356,280,32344.0,0.259
30380,2011,1738,132,1055,611,444,356,255,23750.0,0.242
30380,2012,1713,100,1074,623,451,342,281,28702.0,0.262
30380,2013,1842,139,1093,669,424,314,355,22669.0,0.325
30380,2014,1978,146,1070,659,411,322,337,23708.0,0.315
30380,2015,2029,170,1048,693,355,317,376,22332.0,0.359
30380,2016,2090,182,1074,725,349,332,393,24297.0,0.366
30380,2017,2307,188,1088,764,324,305,459,24722.0,0.422
30380,2018,2202,165,1079,718,361,307,411,29808.0,0.381
30380,2019,2136,186,1025,690,335,265,425,27083.0,0.415
30385,2010,5197,616,2579,1880,699,742,1138,37670.0,0.441
30385,2011,5635,663,2504,1905,599,779,1126,34449.0,0.45
30385,2012,5333,691,2434,1774,660,721,1053,34559.0,0.433
30385,2013,5519,701,2328,1688,640,763,925,34957.0,0.397
30385,2014,5330,683,2316,1648,668,801,847,39922.0,0.366
30385,2015,4870,611,2376,1693,683,746,947,37478.0,0.399
30385,2016,4367,637,2468,1621,847,774,847,40607.0,0.343
30385,2017,4169,697,2437,1608,829,696,912,40150.0,0.374
30385,2018,4169,793,2345,1639,706,659,980,42079.0,0.418
30385,2019,3683,704,2328,1583,745,584,999,44614.0,0.429
30388,2010,1871,100,1081,636,445,356,280,32344.0,0.259
30388,2011,1738,132,1055,611,444,356,255,23750.0,0.242
30388,2012,1713,100,1074,623,451,342,281,28702.0,0.262
30388,2013,1842,139,1093,669,424,314,355,22669.0,0.325
30388,2014,1978,146,1070,659,411,322,337,23708.0,0.315
30388,2015,2029,170,1048,693,355,317,376,22332.0,0.359
30388,2016,2090,182,1074,725,349,332,393,24297.0,0.366
30388,2017,2307,188,1088,764,324,305,459,24722.0,0.422
30388,2018,2202,165,1079,718,361,307,411,29808.0,0.381
30388,2019,2136,186,1025,690,335,265,425,27083.0,0.415
30396,2010,1871,100,1081,636,445,356,280,32344.0,0.259
30396,2011,1738,132,1055,611,444,356,255,23750.0,0.242
30396,2012,1713,100,1074,623,451,342,281,28702.0,0.262
30396,2013,1842,139,1093,669,424,314,355,22669.0,0.325
30396,2014,1978,146,1070,659,411,322,337,23708.0,0.315
30396,2015,2029,170,1048,693,355,317,376,22332.0,0.359
30396,2016,2090,182,1074,725,349,332,393,24297.0,0.366
30396,2017,2307,188,1088,764,324,305,459,24722.0,0.422
30396,2018,2202,165,1079,718,361,307,411,29808.0,0.381
30396,2019,2136,186,1025,690,335,265,425,27083.0,0.415
30398,2010,1871,100,1081,636,445,356,280,32344.0,0.259
30398,2011,1738,132,1055,611,444,356,255,23750.0,0.242
30398,2012,1713,100,1074,623,451,342,281,28702.0,0.262
30398,2013,1842,139,1093,669,424,314,355,22669.0,0.325
30398,2014,1978,146,1070,659,411,322,337,23708.0,0.315
30398,2015,2029,170,1048,693,355,317,376,22332.0,0.359
30398,2016,2090,182,1074,725,349,332,393,24297.0,0.366
30398,2017,2307,188,1088,764,324,305,459,24722.0,0.422
30398,2018,2202,165,1079,718,361,307,411,29808.0,0.381
30398,2019,2136,186,1025,690,335,265,425,27083.0,0.415
30401,2010,45209,3553,20505,16978,3527,11722,5256,39242.11,0.256
30401,2011,45357,3954,20770,16885,3885,11719,5166,40551.67,0.249
30401,2012,45508,4376,20745,16972,3773,12184,4788,41134.44,0.231
30401,2013,46107,4603,20699,17003,3696,12195,4808,41447.11,0.232
30401,2014,46470,5210,20814,17138,3676,12204,4934,40230.44,0.237
30401,2015,46780,5345,20851,17085,3766,12057,5028,40965.67,0.241
30401,2016,46897,5666,20836,17183,3653,12133,5050,41218.22,0.242
30401,2017,47492,5898,21160,17313,3847,12051,5262,42057.0,0.249
30401,2018,47084,5559,21225,17584,3641,12211,5373,44274.22,0.253
30401,2019,47720,5213,21226,17651,3575,12534,5117,47413.78,0.241
30413,2010,7541,782,2651,2267,384,1966,301,55033.0,0.114
30413,2011,7784,696,2557,2254,303,1958,296,58097.0,0.116
30413,2012,7803,814,2609,2281,328,1913,368,59327.0,0.141
30413,2013,7310,797,2604,2278,326,1977,301,58203.0,0.116
30413,2014,6926,697,2491,2235,256,1817,418,52120.0,0.168
30413,2015,6640,813,2486,2263,223,1754,509,60430.0,0.205
30413,2016,6714,685,2538,2284,254,1742,542,60550.0,0.214
30413,2017,7167,587,2643,2369,274,1917,452,59639.0,0.171
30413,2018,6393,462,2500,2157,343,1744,413,63701.0,0.165
30413,2019,6452,494,2539,2213,326,1847,366,65576.0,0.144
30414,2010,10945,803,4723,3964,759,2871,1093,39337.0,0.231
30414,2011,10979,878,4730,3984,746,2825,1159,39211.5,0.245
30414,2012,11425,899,4792,4117,675,3039,1078,40018.0,0.225
30414,2013,10858,829,4687,3910,777,2942,968,40703.5,0.207
30414,2014,11293,1105,4605,3923,682,2959,964,41279.5,0.209
30414,2015,11031,1133,4580,3879,701,2749,1130,40085.5,0.247
30414,2016,11295,1125,4641,3879,762,2827,1052,44623.0,0.227
30414,2017,11713,1187,4645,3853,792,2792,1061,46002.0,0.228
30414,2018,11839,1217,4555,3908,647,2831,1077,48250.0,0.236
30414,2019,11764,1091,4516,3867,649,2884,983,50072.5,0.218
30415,2010,5878,563,2596,2072,524,1479,593,47861.0,0.228
30415,2011,6086,571,2699,2189,510,1505,684,43044.0,0.253
30415,2012,6858,758,2886,2417,469,1626,791,48977.0,0.274
30415,2013,6809,837,2874,2371,503,1449,922,46613.0,0.321
30415,2014,7849,808,3007,2469,538,1484,985,47969.0,0.328
30415,2015,7544,899,2925,2399,526,1375,1024,48832.0,0.35
30415,2016,7676,1044,2752,2409,343,1269,1140,47512.0,0.414
30415,2017,8279,978,2892,2605,287,1297,1308,45853.0,0.452
30415,2018,8320,927,2858,2615,243,1423,1192,49130.0,0.417
30415,2019,7571,1056,2695,2485,210,1406,1079,51042.0,0.4
30417,2010,42624,3443,18671,15753,2918,11008,4745,41047.0,0.254
30417,2011,43231,3871,18920,15797,3123,11249,4548,41946.62,0.24
30417,2012,43825,4307,19130,16115,3015,11665,4450,42793.62,0.233
30417,2013,43811,4559,19304,16116,3188,11836,4280,43337.62,0.222
30417,2014,44535,5015,19441,16227,3214,11987,4240,42222.75,0.218
30417,2015,44649,5270,19405,16170,3235,11784,4386,43279.12,0.226
30417,2016,44810,5534,19401,16261,3140,11903,4358,44063.25,0.225
30417,2017,44894,5547,19700,16348,3352,11767,4581,45041.12,0.233
30417,2018,44961,5388,19585,16495,3090,11819,4676,48032.62,0.239
30417,2019,45760,5407,19785,16714,3071,12180,4534,51250.75,0.229
30420,2010,17406,1573,8109,6571,1538,4813,1758,43381.33,0.217
30420,2011,18098,1954,8366,6649,1717,5074,1575,45519.0,0.188
30420,2012,18131,2188,8406,6838,1568,5276,1562,46529.33,0.186
30420,2013,19098,2506,8569,7090,1479,5531,1559,47107.67,0.182
30420,2014,19285,2717,8837,7175,1662,5579,1596,47263.67,0.181
30420,2015,19634,2889,8931,7274,1657,5708,1566,48216.33,0.175
30420,2016,19423,3149,8786,7295,1491,5620,1675,46216.67,0.191
30420,2017,19732,3392,8982,7392,1590,5574,1818,48458.67,0.202
30420,2018,19118,3134,8991,7327,1664,5553,1774,50337.67,0.197
30420,2019,19790,3127,9176,7601,1575,5821,1780,52601.0,0.194
30421,2010,8023,399,3354,2859,495,1733,1126,36596.5,0.336
30421,2011,7884,406,3353,2818,535,1691,1127,38788.5,0.336
30421,2012,7564,569,3317,2719,598,1702,1017,39252.5,0.307
30421,2013,7442,613,3308,2708,600,1688,1020,38712.0,0.308
30421,2014,7029,681,3240,2711,529,1677,1034,32193.0,0.319
30421,2015,7038,611,3163,2637,526,1626,1011,36663.5,0.32
30421,2016,7091,586,3184,2631,553,1643,988,36138.5,0.31
30421,2017,6791,464,3235,2622,613,1584,1038,34758.0,0.321
30421,2018,7265,390,3347,2829,518,1675,1154,40409.5,0.345
30421,2019,7302,316,3364,2793,571,1623,1170,47330.5,0.348
30423,2010,8023,399,3354,2859,495,1733,1126,36596.5,0.336
30423,2011,7884,406,3353,2818,535,1691,1127,38788.5,0.336
30423,2012,7564,569,3317,2719,598,1702,1017,39252.5,0.307
30423,2013,7442,613,3308,2708,600,1688,1020,38712.0,0.308
30423,2014,7029,681,3240,2711,529,1677,1034,32193.0,0.319
30423,2015,7038,611,3163,2637,526,1626,1011,36663.5,0.32
30423,2016,7091,586,3184,2631,553,1643,988,36138.5,0.31
30423,2017,6791,464,3235,2622,613,1584,1038,34758.0,0.321
30423,2018,7265,390,3347,2829,518,1675,1154,40409.5,0.345
30423,2019,7302,316,3364,2793,571,1623,1170,47330.5,0.348
30424,2010,3219,248,1517,1188,329,766,422,39630.0,0.278
30424,2011,2972,200,1531,1123,408,754,369,40795.0,0.241
30424,2012,3037,208,1600,1198,402,867,331,39695.0,0.207
30424,2013,3243,292,1602,1259,343,867,392,39362.0,0.245
30424,2014,3332,395,1563,1242,321,825,417,40395.0,0.267
30424,2015,3539,421,1535,1242,293,876,366,39781.0,0.238
30424,2016,3641,505,1501,1289,212,894,395,37989.0,0.263
30424,2017,4050,513,1549,1394,155,894,500,38648.0,0.323
30424,2018,3775,475,1536,1365,171,948,417,37414.0,0.271
30424,2019,3811,439,1507,1359,148,913,446,37976.0,0.296
30425,2010,47401,3966,20151,17193,2958,13283,3910,44604.57,0.194
30425,2011,48459,4652,20515,17470,3045,13420,4050,44897.86,0.197
30425,2012,50152,5071,20885,18057,2828,13925,4132,46768.14,0.198
30425,2013,51200,5401,21026,18217,2809,14140,4077,46610.0,0.194
30425,2014,51210,5841,21140,18283,2857,13961,4322,47054.29,0.204
30425,2015,51288,6038,21168,18311,2857,13763,4548,47618.0,0.215
30425,2016,51036,6549,21207,18499,2708,13524,4975,47587.86,0.235
30425,2017,51260,6993,21299,18505,2794,13631,4874,48909.14,0.229
30425,2018,51791,7101,21541,18723,2818,13823,4900,51501.71,0.227
30425,2019,51867,7002,21602,18856,2746,14252,4604,54858.14,0.213
30426,2010,10945,803,4723,3964,759,2871,1093,39337.0,0.231
30426,2011,10979,878,4730,3984,746,2825,1159,39211.5,0.245
30426,2012,11425,899,4792,4117,675,3039,1078,40018.0,0.225
30426,2013,10858,829,4687,3910,777,2942,968,40703.5,0.207
30426,2014,11293,1105,4605,3923,682,2959,964,41279.5,0.209
30426,2015,11031,1133,4580,3879,701,2749,1130,40085.5,0.247
30426,2016,11295,1125,4641,3879,762,2827,1052,44623.0,0.227
30426,2017,11713,1187,4645,3853,792,2792,1061,46002.0,0.228
30426,2018,11839,1217,4555,3908,647,2831,1077,48250.0,0.236
30426,2019,11764,1091,4516,3867,649,2884,983,50072.5,0.218
30427,2010,28351,2376,12832,10535,2297,7684,2851,41763.6,0.222
30427,2011,29077,2832,13096,10633,2463,7899,2734,42996.0,0.209
30427,2012,29556,3087,13198,10955,2243,8315,2640,43924.8,0.2
30427,2013,29956,3335,13256,11000,2256,8473,2527,44546.0,0.191
30427,2014,30578,3822,13442,11098,2344,8538,2560,44870.0,0.19
30427,2015,30665,4022,13511,11153,2358,8457,2696,44964.0,0.2
30427,2016,30718,4274,13427,11174,2253,8447,2727,45579.2,0.203
30427,2017,31445,4579,13627,11245,2382,8366,2879,47476.0,0.211
30427,2018,30957,4351,13546,11235,2311,8384,2851,49502.6,0.21
30427,2019,31554,4218,13692,11468,2224,8705,2763,51589.6,0.202
30429,2010,8023,399,3354,2859,495,1733,1126,36596.5,0.336
30429,2011,7884,406,3353,2818,535,1691,1127,38788.5,0.336
30429,2012,7564,569,3317,2719,598,1702,1017,39252.5,0.307
30429,2013,7442,613,3308,2708,600,1688,1020,38712.0,0.308
30429,2014,7029,681,3240,2711,529,1677,1034,32193.0,0.319
30429,2015,7038,611,3163,2637,526,1626,1011,36663.5,0.32
30429,2016,7091,586,3184,2631,553,1643,988,36138.5,0.31
30429,2017,6791,464,3235,2622,613,1584,1038,34758.0,0.321
30429,2018,7265,390,3347,2829,518,1675,1154,40409.5,0.345
30429,2019,7302,316,3364,2793,571,1623,1170,47330.5,0.348
30434,2010,18452,1581,6847,5945,902,4835,1110,48773.5,0.162
30434,2011,18633,1571,6710,5955,755,4701,1254,50196.0,0.187
30434,2012,19760,1732,7100,6302,798,4816,1486,52207.5,0.209
30434,2013,19465,1730,7033,6282,751,4855,1427,51554.0,0.203
30434,2014,18717,1546,6787,6115,672,4475,1640,49016.5,0.242
30434,2015,18391,1523,6802,6163,639,4247,1916,52556.0,0.282
30434,2016,18056,1405,6937,6317,620,4053,2264,51865.5,0.326
30434,2017,17818,1345,6934,6342,592,4374,1968,51279.0,0.284
30434,2018,17781,1433,7057,6313,744,4363,1950,55250.0,0.276
30434,2019,17551,1426,6939,6244,695,4474,1770,57553.5,0.255
30436,2010,57811,4975,26777,21878,4899,15568,6310,40887.27,0.236
30436,2011,58543,5702,27314,21839,5475,15856,5983,42249.09,0.219
30436,2012,59112,6203,27434,22289,5145,16625,5664,42817.09,0.206
30436,2013,61006,6788,27562,22644,4918,16905,5739,43298.64,0.208
30436,2014,62058,7641,27974,22844,5130,16931,5913,43624.91,0.211
30436,2015,62915,8044,28154,22964,5190,17015,5949,43617.64,0.211
30436,2016,62870,8734,27939,23136,4803,17004,6132,43211.45,0.219
30436,2017,64483,9339,28456,23477,4979,16935,6542,44820.09,0.23
30436,2018,62712,8778,28405,23447,4958,17037,6410,46006.91,0.226
30436,2019,64019,8463,28545,23818,4727,17645,6173,47985.64,0.216
30439,2010,29534,2804,13190,11002,2188,7883,3119,44874.0,0.236
30439,2011,30454,3158,13536,11184,2352,8238,2946,44523.4,0.218
30439,2012,31694,3597,13907,11696,2211,8550,3146,46557.0,0.226
30439,2013,32320,3954,14183,11869,2314,8655,3214,46896.6,0.227
30439,2014,34062,4037,14603,12062,2541,8835,3227,47761.2,0.221
30439,2015,34124,4425,14587,12053,2534,8784,3269,48313.4,0.224
30439,2016,34100,4867,14328,12160,2168,8702,3458,47699.0,0.241
30439,2017,34669,4874,14712,12478,2234,8688,3790,48932.4,0.258
30439,2018,34177,4708,14541,12373,2168,8736,3637,51214.4,0.25
30439,2019,34265,5056,14600,12539,2061,9079,3460,53248.4,0.237
30441,2010,29879,2001,12273,10501,1772,7473,3028,38876.2,0.247
30441,2011,29712,2159,12236,10503,1733,7259,3244,39659.0,0.265
30441,2012,30946,2386,12600,10857,1743,7644,3213,40725.8,0.255
30441,2013,30455,2375,12424,10622,1802,7508,3114,40747.2,0.251
30441,2014,30113,2635,12141,10514,1627,7294,3220,38571.6,0.265
30441,2015,29820,2454,12059,10416,1643,6868,3548,39636.0,0.294
30441,2016,29728,2431,12224,10543,1681,6781,3762,40940.8,0.308
30441,2017,29155,2409,12171,10448,1723,6833,3615,40887.8,0.297
30441,2018,30492,2578,12459,10893,1566,7125,3768,44823.6,0.302
30441,2019,30165,2339,12280,10691,1589,7134,3557,48867.4,0.29
30442,2010,36340,2771,15659,13108,2551,9415,3693,40975.17,0.236
30442,2011,36831,3235,15872,13168,2704,9508,3660,42738.17,0.231
30442,2012,37652,3675,16214,13578,2636,9881,3697,43863.5,0.228
30442,2013,38695,4052,16306,13802,2504,10097,3705,43942.0,0.227
30442,2014,38105,4247,16373,13766,2607,9914,3852,42015.0,0.235
30442,2015,38423,4210,16410,13811,2599,9827,3984,43776.33,0.243
30442,2016,37856,4455,16369,13959,2410,9574,4385,42351.33,0.268
30442,2017,37174,4614,16508,13987,2521,9615,4372,42968.5,0.265
30442,2018,37771,4495,16895,14312,2583,9847,4465,46438.5,0.264
30442,2019,38191,4375,16940,14425,2515,10071,4354,50332.5,0.257
30446,2010,5616,530,2802,2396,406,1539,857,31538.0,0.306
30446,2011,5424,516,2790,2311,479,1375,936,31613.0,0.335
30446,2012,5351,512,2630,2100,530,1300,800,32386.0,0.304
30446,2013,5466,363,2533,2036,497,1167,869,33508.0,0.343
30446,2014,5531,312,2569,2087,482,1164,923,32943.0,0.359
30446,2015,5538,291,2642,2053,589,1098,955,30763.0,0.361
30446,2016,5447,301,2724,2089,635,1149,940,32802.0,0.345
30446,2017,5206,342,2749,2052,697,1207,845,32969.0,0.307
30446,2018,5087,343,2796,2155,641,1204,951,32722.0,0.34
30446,2019,5053,240,2663,2031,632,1293,738,36139.0,0.277
30448,2010,3219,248,1517,1188,329,766,422,39630.0,0.278
30448,2011,2972,200,1531,1123,408,754,369,40795.0,0.241
30448,2012,3037,208,1600,1198,402,867,331,39695.0,0.207
30448,2013,3243,292,1602,1259,343,867,392,39362.0,0.245
30448,2014,3332,395,1563,1242,321,825,417,40395.0,0.267
30448,2015,3539,421,1535,1242,293,876,366,39781.0,0.238
30448,2016,3641,505,1501,1289,212,894,395,37989.0,0.263
30448,2017,4050,513,1549,1394,155,894,500,38648.0,0.323
30448,2018,3775,475,1536,1365,171,948,417,37414.0,0.271
30448,2019,3811,439,1507,1359,148,913,446,37976.0,0.296
30449,2010,5616,530,2802,2396,406,1539,857,31538.0,0.306
30449,2011,5424,516,2790,2311,479,1375,936,31613.0,0.335
30449,2012,5351,512,2630,2100,530,1300,800,32386.0,0.304
30449,2013,5466,363,2533,2036,497,1167,869,33508.0,0.343
30449,2014,5531,312,2569,2087,482,1164,923,32943.0,0.359
30449,2015,5538,291,2642,2053,589,1098,955,30763.0,0.361
30449,2016,5447,301,2724,2089,635,1149,940,32802.0,0.345
30449,2017,5206,342,2749,2052,697,1207,845,32969.0,0.307
30449,2018,5087,343,2796,2155,641,1204,951,32722.0,0.34
30449,2019,5053,240,2663,2031,632,1293,738,36139.0,0.277
30450,2010,32322,2849,14369,12362,2007,8777,3585,44425.0,0.249
30450,2011,33116,3422,14866,12600,2266,9181,3419,44230.8,0.23
30450,2012,33625,4044,14848,12811,2037,9333,3478,47069.4,0.234
30450,2013,34602,4261,15045,12974,2071,9520,3454,46097.0,0.23
30450,2014,34607,4372,15332,13007,2325,9498,3509,46601.6,0.229
30450,2015,35440,4712,15159,12996,2163,9507,3489,48414.2,0.23
30450,2016,34975,5206,14948,13024,1924,9332,3692,47539.4,0.247
30450,2017,35454,5470,15253,13178,2075,9461,3717,48728.0,0.244
30450,2018,35137,5348,15289,13177,2112,9413,3764,50593.6,0.246
30450,2019,35762,5469,15460,13443,2017,9725,3718,53851.8,0.24
30452,2010,30433,2726,13731,11741,1990,7638,4103,41518.0,0.299
30452,2011,30853,3110,14071,11810,2261,8062,3748,41432.0,0.266
30452,2012,31691,3629,14267,12171,2096,8274,3897,43380.4,0.273
30452,2013,31926,3739,14444,12169,2275,8406,3763,43679.4,0.261
30452,2014,32694,3714,14689,12120,2569,8505,3615,44587.4,0.246
30452,2015,33514,4043,14549,12118,2431,8395,3723,45266.6,0.256
30452,2016,33000,4325,14357,12188,2169,8379,3809,45598.4,0.265
30452,2017,32948,4318,14710,12372,2338,8470,3902,47001.6,0.265
30452,2018,32430,4216,14543,12276,2267,8353,3923,48539.4,0.27
30452,2019,33452,4490,14679,12539,2140,8657,3882,50025.6,0.264
30453,2010,14164,1051,6240,5152,1088,3637,1515,39434.67,0.243
30453,2011,13951,1078,6261,5107,1154,3579,1528,39739.33,0.244
30453,2012,14462,1107,6392,5315,1077,3906,1409,39910.33,0.22
30453,2013,14101,1121,6289,5169,1120,3809,1360,40256.33,0.216
30453,2014,14625,1500,6168,5165,1003,3784,1381,40984.67,0.224
30453,2015,14570,1554,6115,5121,994,3625,1496,39984.0,0.245
30453,2016,14936,1630,6142,5168,974,3721,1447,42411.67,0.236
30453,2017,15763,1700,6194,5247,947,3686,1561,43550.67,0.252
30453,2018,15614,1692,6091,5273,818,3779,1494,44638.0,0.245
30453,2019,15575,1530,6023,5226,797,3797,1429,46040.33,0.237
30455,2010,11242,647,4871,4047,824,2499,1548,37607.67,0.318
30455,2011,10856,606,4884,3941,943,2445,1496,39457.33,0.306
30455,2012,10601,777,4917,3917,1000,2569,1348,39400.0,0.274
30455,2013,10685,905,4910,3967,943,2555,1412,38928.67,0.288
30455,2014,10361,1076,4803,3953,850,2502,1451,34927.0,0.302
30455,2015,10577,1032,4698,3879,819,2502,1377,37702.67,0.293
30455,2016,10732,1091,4685,3920,765,2537,1383,36755.33,0.295
30455,2017,10841,977,4784,4016,768,2478,1538,36054.67,0.321
30455,2018,11040,865,4883,4194,689,2623,1571,39411.0,0.322
30455,2019,11113,755,4871,4152,719,2536,1616,44212.33,0.332
30457,2010,19746,1577,8515,7262,1253,5174,2088,37894.0,0.245
30457,2011,19245,1591,8474,7135,1339,4872,2263,38234.33,0.267
30457,2012,20345,1638,8721,7319,1402,5070,2249,39056.33,0.258
30457,2013,20864,1588,8564,7299,1265,4912,2387,39258.33,0.279
30457,2014,20654,1556,8428,7209,1219,4647,2562,39750.33,0.304
30457,2015,20828,1422,8493,7195,1298,4467,2728,38408.67,0.321
30457,2016,20430,1526,8624,7411,1213,4354,3057,37990.67,0.354
30457,2017,19907,1613,8589,7419,1170,4558,2861,38178.67,0.333
30457,2018,20250,1789,8889,7676,1213,4771,2905,38978.33,0.327
30457,2019,19963,1611,8570,7421,1149,4833,2588,41215.33,0.302
30458,2010,40454,4366,16597,15037,1560,11163,3874,52786.0,0.233
30458,2011,41032,4530,16947,15285,1662,11445,3840,52114.43,0.227
30458,2012,42894,5442,17208,15639,1569,11498,4141,55195.86,0.241
30458,2013,42983,5261,17344,15527,1817,11401,4126,53078.86,0.238
30458,2014,44255,4808,17516,15573,1943,11281,4292,54557.14,0.245
30458,2015,44490,5296,17273,15435,1838,11035,4400,55000.14,0.255
30458,2016,44778,5825,17306,15749,1557,11105,4644,54981.57,0.268
30458,2017,45448,5598,17564,16049,1515,11335,4714,54534.43,0.268
30458,2018,45958,6110,17540,16181,1359,11509,4672,57599.0,0.266
30458,2019,46288,6841,17634,16340,1294,12027,4313,61274.14,0.245
30461,2010,27427,3213,10975,9867,1108,8338,1529,58411.2,0.139
30461,2011,28277,3374,11242,10124,1118,8457,1667,58839.6,0.148
30461,2012,29334,4001,11347,10306,1041,8500,1806,61811.4,0.159
30461,2013,30155,4028,11469,10448,1021,8526,1922,58895.6,0.168
30461,2014,30846,3811,11664,10628,1036,8355,2273,60150.8,0.195
30461,2015,30610,4142,11655,10591,1064,8348,2243,60663.4,0.192
30461,2016,31201,4649,11735,10856,879,8346,2510,59105.8,0.214
30461,2017,32232,4672,11836,11069,767,8439,2630,58421.8,0.222
30461,2018,32646,5028,11988,11232,756,8709,2523,62301.8,0.21
30461,2019,32626,5478,12131,11402,729,9191,2211,67318.8,0.182
30464,2010,17406,1573,8109,6571,1538,4813,1758,43381.33,0.217
30464,2011,18098,1954,8366,6649,1717,5074,1575,45519.0,0.188
30464,2012,18131,2188,8406,6838,1568,5276,1562,46529.33,0.186
30464,2013,19098,2506,8569,7090,1479,5531,1559,47107.67,0.182
30464,2014,19285,2717,8837,7175,1662,5579,1596,47263.67,0.181
30464,2015,19634,2889,8931,7274,1657,5708,1566,48216.33,0.175
30464,2016,19423,3149,8786,7295,1491,5620,1675,46216.67,0.191
30464,2017,19732,3392,8982,7392,1590,5574,1818,48458.67,0.202
30464,2018,19118,3134,8991,7327,1664,5553,1774,50337.67,0.197
30464,2019,19790,3127,9176,7601,1575,5821,1780,52601.0,0.194
30467,2010,27803,1980,12396,10407,1989,6909,3498,37172.5,0.282
30467,2011,27259,2000,12404,10236,2168,6645,3591,38068.0,0.29
30467,2012,27377,2188,12339,10134,2205,6908,3226,38437.0,0.261
30467,2013,27009,2097,12130,9913,2217,6664,3249,38616.83,0.268
30467,2014,27185,2493,11977,9963,2014,6625,3338,36713.83,0.279
30467,2015,27146,2456,11920,9811,2109,6349,3462,37340.33,0.29
30467,2016,27474,2517,12050,9888,2162,6513,3375,38719.0,0.28
30467,2017,27760,2506,12178,9921,2257,6477,3444,38856.17,0.283
30467,2018,27966,2425,12234,10257,1977,6658,3599,41242.5,0.294
30467,2019,27930,2086,12050,10050,2000,6713,3337,44820.17,0.277
30470,2010,10911,799,4196,3678,518,2869,809,42514.0,0.193
30470,2011,10849,875,4153,3701,452,2743,958,42295.0,0.231
30470,2012,11957,918,4491,4021,470,2903,1118,45088.0,0.249
30470,2013,12155,933,4429,4004,425,2878,1126,44905.0,0.254
30470,2014,11791,849,4296,3880,416,2658,1222,45913.0,0.284
30470,2015,11751,710,4316,3900,416,2493,1407,44682.0,0.326
30470,2016,11342,720,4399,4033,366,2311,1722,43181.0,0.391
30470,2017,10651,758,4291,3973,318,2457,1516,42919.0,0.353
30470,2018,11388,971,4557,4156,401,2619,1537,46799.0,0.337
30470,2019,11099,932,4400,4031,369,2627,1404,49531.0,0.319
30471,2010,47732,3814,20826,17562,3264,12913,4649,42504.56,0.223
30471,2011,48466,4383,21246,17710,3536,13122,4588,43373.56,0.216
30471,2012,48796,4930,21311,17953,3358,13591,4362,44498.78,0.205
30471,2013,49730,5373,21507,18180,3327,13817,4363,44239.0,0.203
30471,2014,49780,6068,21647,18356,3291,13805,4551,43138.67,0.21
30471,2015,50114,6360,21550,18290,3260,13772,4518,44639.11,0.21
30471,2016,50426,6920,21493,18386,3107,13750,4636,44466.67,0.216
30471,2017,51450,7212,21792,18548,3244,13652,4896,45289.89,0.225
30471,2018,51443,6995,21867,18761,3106,13827,4934,47994.0,0.226
30471,2019,51881,6825,22073,18977,3096,14161,4816,51901.44,0.218
30473,2010,3219,248,1517,1188,329,766,422,39630.0,0.278
30473,2011,2972,200,1531,1123,408,754,369,40795.0,0.241
30473,2012,3037,208,1600,1198,402,867,331,39695.0,0.207
30473,2013,3243,292,1602,1259,343,867,392,39362.0,0.245
30473,2014,3332,395,1563,1242,321,825,417,40395.0,0.267
30473,2015,3539,421,1535,1242,293,876,366,39781.0,0.238
30473,2016,3641,505,1501,1289,212,894,395,37989.0,0.263
30473,2017,4050,513,1549,1394,155,894,500,38648.0,0.323
30473,2018,3775,475,1536,1365,171,948,417,37414.0,0.271
30473,2019,3811,439,1507,1359,148,913,446,37976.0,0.296
30474,2010,41933,3027,18109,15273,2836,10544,4729,38147.38,0.261
30474,2011,41080,3075,18088,15060,3028,10142,4918,38937.25,0.272
30474,2012,42371,3314,18430,15353,3077,10678,4675,39425.62,0.254
30474,2013,42407,3322,18161,15176,2985,10409,4767,39496.0,0.262
30474,2014,42308,3737,17836,15085,2751,10108,4977,38323.88,0.279
30474,2015,42436,3587,17771,14953,2818,9718,5235,38563.12,0.295
30474,2016,42457,3742,17950,15210,2740,9718,5492,39185.5,0.306
30474,2017,42461,3777,18018,15288,2730,9828,5460,39338.0,0.303
30474,2018,43129,3871,18327,15778,2549,10225,5553,41458.5,0.303
30474,2019,42840,3457,17957,15440,2517,10253,5187,44553.5,0.289
30477,2010,18486,1585,7374,6231,1143,4837,1394,44569.0,0.189
30477,2011,18763,1574,7287,6238,1049,4783,1455,45506.67,0.2
30477,2012,19228,1713,7401,6398,1003,4952,1446,46454.33,0.195
30477,2013,18168,1626,7291,6188,1103,4919,1269,46536.67,0.174
30477,2014,18219,1802,7096,6158,938,4776,1382,44893.0,0.195
30477,2015,17671,1946,7066,6142,924,4503,1639,46867.0,0.232
30477,2016,18009,1810,7179,6163,1016,4569,1594,49932.0,0.222
30477,2017,18880,1774,7288,6222,1066,4709,1513,50547.67,0.208
30477,2018,18232,1679,7055,6065,990,4575,1490,53400.33,0.211
30477,2019,18216,1585,7055,6080,975,4731,1349,55240.33,0.191
30501,2010,13248,6828,8642,6878,1764,3008,3870,69320.25,0.448
30501,2011,15359,7430,9565,7622,1943,3305,4317,70972.25,0.451
30501,2012,16036,7348,9799,7714,2085,3148,4566,69681.0,0.466
30501,2013,16022,7531,9855,7712,2143,3021,4691,70249.0,0.476
30501,2014,16701,7776,10140,7861,2279,3105,4756,68937.5,0.469
30501,2015,16872,8110,10185,8046,2139,3050,4996,73685.5,0.491
30501,2016,17268,8514,10266,8260,2006,3192,5068,71222.0,0.494
30501,2017,17757,9087,10633,8700,1933,3239,5461,71794.75,0.514
30501,2018,19138,9304,10845,9103,1742,3290,5813,73634.5,0.536
30501,2019,19745,9950,11212,9744,1468,3460,6284,80389.75,0.56
30504,2010,11500,1360,1703,1366,337,647,719,65187.5,0.422
30504,2011,10082,1662,1764,1395,369,644,751,68889.0,0.426
30504,2012,9967,1693,1732,1397,335,553,844,70880.5,0.487
30504,2013,9572,1516,1733,1381,352,544,837,64983.0,0.483
30504,2014,9192,1449,1738,1317,421,528,789,62617.0,0.454
30504,2015,8822,1424,1708,1311,397,506,805,66446.5,0.471
30504,2016,8887,1428,1682,1335,347,560,775,59121.5,0.461
30504,2017,8803,1458,1775,1427,348,578,849,59553.5,0.478
30504,2018,8973,1533,1766,1492,274,635,857,60180.0,0.485
30504,2019,9352,1647,1808,1535,273,675,860,64149.5,0.476
30506,2010,21373,6612,10393,8695,1698,6574,2121,73263.71,0.204
30506,2011,22593,6921,10847,8828,2019,6628,2200,74493.57,0.203
30506,2012,22017,6935,10896,8701,2195,6337,2364,73829.14,0.217
30506,2013,22857,7129,11130,8842,2288,6619,2223,75966.43,0.2
30506,2014,23701,7191,11279,8975,2304,6513,2462,75284.29,0.218
30506,2015,24150,8099,11405,9233,2172,6638,2595,80317.71,0.228
30506,2016,24790,8444,11598,9719,1879,7126,2593,80705.57,0.224
30506,2017,24822,8193,11614,9737,1877,7128,2609,81955.0,0.225
30506,2018,25038,7954,11692,9783,1909,7112,2671,87442.29,0.228
30506,2019,25026,8371,11704,9992,1712,7388,2604,90898.86,0.222
30507,2010,10930,5423,7507,6136,1371,2387,3749,56267.33,0.499
30507,2011,12731,6011,8299,6738,1561,2568,4170,55864.0,0.502
30507,2012,13348,6054,8547,6927,1620,2537,4390,53996.33,0.514
30507,2013,13228,6428,8604,7086,1518,2419,4667,54149.33,0.542
30507,2014,13418,6471,8809,7245,1564,2511,4734,56177.33,0.537
30507,2015,13707,6594,8954,7437,1517,2514,4923,57034.33,0.55
30507,2016,14089,7102,8973,7585,1388,2587,4998,58515.33,0.557
30507,2017,14521,7865,9385,8008,1377,2732,5276,64211.67,0.562
30507,2018,16508,8435,9937,8596,1341,2810,5786,65330.0,0.582
30507,2019,17685,9173,10461,9294,1167,2927,6367,75768.33,0.609
30510,2010,28351,2376,12832,10535,2297,7684,2851,41763.6,0.222
30510,2011,29077,2832,13096,10633,2463,7899,2734,42996.0,0.209
30510,2012,29556,3087,13198,10955,2243,8315,2640,43924.8,0.2
30510,2013,29956,3335,13256,11000,2256,8473,2527,44546.0,0.191
30510,2014,30578,3822,13442,11098,2344,8538,2560,44870.0,0.19
30510,2015,30665,4022,13511,11153,2358,8457,2696,44964.0,0.2
30510,2016,30718,4274,13427,11174,2253,8447,2727,45579.2,0.203
30510,2017,31445,4579,13627,11245,2382,8366,2879,47476.0,0.211
30510,2018,30957,4351,13546,11235,2311,8384,2851,49502.6,0.21
30510,2019,31554,4218,13692,11468,2224,8705,2763,51589.6,0.202
30511,2010,17406,1573,8109,6571,1538,4813,1758,43381.33,0.217
30511,2011,18098,1954,8366,6649,1717,5074,1575,45519.0,0.188
30511,2012,18131,2188,8406,6838,1568,5276,1562,46529.33,0.186
30511,2013,19098,2506,8569,7090,1479,5531,1559,47107.67,0.182
30511,2014,19285,2717,8837,7175,1662,5579,1596,47263.67,0.181
30511,2015,19634,2889,8931,7274,1657,5708,1566,48216.33,0.175
30511,2016,19423,3149,8786,7295,1491,5620,1675,46216.67,0.191
30511,2017,19732,3392,8982,7392,1590,5574,1818,48458.67,0.202
30511,2018,19118,3134,8991,7327,1664,5553,1774,50337.67,0.197
30511,2019,19790,3127,9176,7601,1575,5821,1780,52601.0,0.194
30512,2010,14305,1647,5304,4823,481,3732,1091,60385.5,0.206
30512,2011,14071,1679,5385,4710,675,3616,1094,58059.5,0.203
30512,2012,13839,1616,5352,4652,700,3638,1014,60510.0,0.189
30512,2013,13777,1675,5408,4747,661,3766,981,57139.5,0.181
30512,2014,14035,1908,5324,4795,529,3893,902,61155.5,0.169
30512,2015,13598,1986,5361,4842,519,3856,986,61707.5,0.184
30512,2016,14662,2139,5419,5115,304,4067,1048,62077.0,0.193
30512,2017,14736,2098,5476,5159,317,4224,935,65683.5,0.171
30512,2018,14097,1825,5289,4991,298,3968,1023,63412.0,0.193
30512,2019,14986,1879,5571,5255,316,4136,1119,66521.0,0.201
30513,2010,18956,1697,7800,6886,914,5083,1803,47087.0,0.231
30513,2011,19140,1739,7725,6921,804,5095,1826,45715.75,0.236
30513,2012,18998,1860,7804,6948,856,5118,1830,47589.25,0.234
30513,2013,18980,1912,7749,6739,1010,4972,1767,47739.0,0.228
30513,2014,18987,2049,7727,6673,1054,4852,1821,47973.75,0.236
30513,2015,18880,2201,7721,6846,875,5042,1804,49022.0,0.234
30513,2016,18897,2141,7891,6935,956,5011,1924,50680.25,0.244
30513,2017,19113,2118,7915,7065,850,5122,1943,54808.25,0.245
30513,2018,19153,2075,7997,7273,724,5051,2222,56820.5,0.278
30513,2019,19903,2164,8102,7312,790,5064,2248,59992.5,0.277
30515,2010,4036,176,1446,1304,142,696,608,30395.0,0.42
30515,2011,4121,243,1388,1326,62,661,665,41840.0,0.479
30515,2012,4091,197,1378,1270,108,600,670,38289.0,0.486
30515,2013,4087,217,1317,1202,115,589,613,34692.0,0.465
30515,2014,4118,280,1378,1195,183,601,594,36708.0,0.431
30515,2015,3825,201,1384,1194,190,598,596,38793.0,0.431
30515,2016,3720,184,1361,1139,222,574,565,36458.0,0.415
30515,2017,3977,236,1410,1245,165,569,676,36006.0,0.479
30515,2018,4485,376,1616,1435,181,771,664,50015.0,0.411
30515,2019,5108,420,1656,1545,111,800,745,53785.0,0.45
30516,2010,10911,799,4196,3678,518,2869,809,42514.0,0.193
30516,2011,10849,875,4153,3701,452,2743,958,42295.0,0.231
30516,2012,11957,918,4491,4021,470,2903,1118,45088.0,0.249
30516,2013,12155,933,4429,4004,425,2878,1126,44905.0,0.254
30516,2014,11791,849,4296,3880,416,2658,1222,45913.0,0.284
30516,2015,11751,710,4316,3900,416,2493,1407,44682.0,0.326
30516,2016,11342,720,4399,4033,366,2311,1722,43181.0,0.391
30516,2017,10651,758,4291,3973,318,2457,1516,42919.0,0.353
30516,2018,11388,971,4557,4156,401,2619,1537,46799.0,0.337
30516,2019,11099,932,4400,4031,369,2627,1404,49531.0,0.319
30517,2010,14624,2974,4750,4247,503,3644,603,75106.5,0.127
30517,2011,16268,3400,5066,4525,541,4034,491,66965.0,0.097
30517,2012,16147,3536,5220,4608,612,4153,455,70946.0,0.087
30517,2013,16365,3454,5422,4737,685,4276,461,72102.5,0.085
30517,2014,17050,3674,5514,4906,608,4422,484,74569.0,0.088
30517,2015,16206,3793,5661,5050,611,4411,639,80508.0,0.113
30517,2016,16834,3917,5644,5071,573,4375,696,84724.5,0.123
30517,2017,17858,4192,5893,5357,536,4640,717,88128.5,0.122
30517,2018,19422,4696,6203,5826,377,4994,832,94837.5,0.134
30517,2019,20412,5455,6617,6251,366,5384,867,96384.0,0.131
30518,2010,67386,17195,23612,21625,1987,18067,3558,76737.5,0.151
30518,2011,69686,17818,24093,21998,2095,18069,3929,77892.5,0.163
30518,2012,72107,18106,24333,22325,2008,18085,4240,77864.38,0.174
30518,2013,73065,17833,24313,22404,1909,18242,4162,76395.75,0.171
30518,2014,74499,18926,24836,23065,1771,18635,4430,76416.25,0.178
30518,2015,76357,19562,24928,23358,1570,18577,4781,78713.0,0.192
30518,2016,77920,19895,24829,23492,1337,18733,4759,79528.0,0.192
30518,2017,78556,20498,25285,24155,1130,19290,4865,83038.88,0.192
30518,2018,81053,22453,26066,25007,1059,20004,5003,88796.25,0.192
30518,2019,82055,23334,26440,25202,1238,20452,4750,94544.12,0.18
30519,2010,84200,17745,29113,26830,2283,21781,5049,67331.88,0.173
30519,2011,88008,19020,29877,27440,2437,22053,5387,69836.25,0.18
30519,2012,91037,19536,30130,27759,2371,21863,5896,70151.25,0.196
30519,2013,92120,19614,30393,27767,2626,21825,5942,69256.62,0.196
30519,2014,94780,20352,31061,28665,2396,22196,6469,70314.5,0.208
30519,2015,96285,22178,31596,29316,2280,22241,7075,70231.25,0.224
30519,2016,100766,23111,31955,30042,1913,22353,7689,71989.12,0.241
30519,2017,100404,23178,32269,30376,1893,22709,7667,75138.5,0.238
30519,2018,105014,25798,33421,32188,1233,24227,7961,81270.12,0.238
30519,2019,107084,27502,34107,32684,1423,24223,8461,81828.62,0.248
30520,2010,18452,1581,6847,5945,902,4835,1110,48773.5,0.162
30520,2011,18633,1571,6710,5955,755,4701,1254,50196.0,0.187
30520,2012,19760,1732,7100,6302,798,4816,1486,52207.5,0.209
30520,2013,19465,1730,7033,6282,751,4855,1427,51554.0,0.203
30520,2014,18717,1546,6787,6115,672,4475,1640,49016.5,0.242
30520,2015,18391,1523,6802,6163,639,4247,1916,52556.0,0.282
30520,2016,18056,1405,6937,6317,620,4053,2264,51865.5,0.326
30520,2017,17818,1345,6934,6342,592,4374,1968,51279.0,0.284
30520,2018,17781,1433,7057,6313,744,4363,1950,55250.0,0.276
30520,2019,17551,1426,6939,6244,695,4474,1770,57553.5,0.255
30521,2010,28351,2376,12832,10535,2297,7684,2851,41763.6,0.222
30521,2011,29077,2832,13096,10633,2463,7899,2734,42996.0,0.209
30521,2012,29556,3087,13198,10955,2243,8315,2640,43924.8,0.2
30521,2013,29956,3335,13256,11000,2256,8473,2527,44546.0,0.191
30521,2014,30578,3822,13442,11098,2344,8538,2560,44870.0,0.19
30521,2015,30665,4022,13511,11153,2358,8457,2696,44964.0,0.2
30521,2016,30718,4274,13427,11174,2253,8447,2727,45579.2,0.203
30521,2017,31445,4579,13627,11245,2382,8366,2879,47476.0,0.211
30521,2018,30957,4351,13546,11235,2311,8384,2851,49502.6,0.21
30521,2019,31554,4218,13692,11468,2224,8705,2763,51589.6,0.202
30522,2010,12303,1020,4876,4413,463,3561,852,50702.33,0.175
30522,2011,12416,1029,4776,4385,391,3534,851,48857.0,0.178
30522,2012,12296,1129,4844,4388,456,3541,847,51190.33,0.175
30522,2013,12369,1098,4877,4287,590,3463,824,50726.33,0.169
30522,2014,12790,1323,4934,4362,572,3467,895,50687.33,0.181
30522,2015,12614,1283,5068,4439,629,3516,923,49993.67,0.182
30522,2016,12683,1276,5155,4537,618,3586,951,50475.33,0.184
30522,2017,12791,1230,5075,4543,532,3612,931,56231.0,0.183
30522,2018,12633,1231,5021,4589,432,3476,1113,58430.33,0.222
30522,2019,13312,1232,5147,4689,458,3429,1260,60881.67,0.245
30523,2010,8524,4926,5049,4134,915,2893,1241,97669.5,0.246
30523,2011,8775,5018,5256,4180,1076,2834,1346,100154.0,0.256
30523,2012,8647,4852,5316,4112,1204,2723,1389,98794.5,0.261
30523,2013,8955,4900,5296,4104,1192,2734,1370,101842.0,0.259
30523,2014,9628,5175,5421,4172,1249,2738,1434,105096.5,0.265
30523,2015,10121,5828,5516,4414,1102,2792,1622,114341.5,0.294
30523,2016,10322,5876,5586,4593,993,2946,1647,115226.0,0.295
30523,2017,10755,6013,5622,4672,950,2961,1711,117600.0,0.304
30523,2018,10690,5783,5690,4659,1031,2923,1736,123338.0,0.305
30523,2019,10629,6075,5737,4927,810,3063,1864,129268.0,0.325
30525,2010,39888,4061,17197,14271,2926,11203,3068,49182.83,0.178
30525,2011,40835,4540,17340,14172,3168,11209,2963,50304.33,0.171
30525,2012,40967,5006,17523,14555,2968,11276,3279,51270.83,0.187
30525,2013,41244,5435,17639,14880,2759,11386,3494,51200.67,0.198
30525,2014,40906,5787,17768,14663,3105,11277,3386,51437.83,0.191
30525,2015,40975,6253,17919,14727,3192,11221,3506,54276.83,0.196
30525,2016,41033,6648,17978,14947,3031,11431,3516,54430.67,0.196
30525,2017,41949,7107,18416,15093,3323,11753,3340,56321.0,0.181
30525,2018,41340,6836,18494,14988,3506,11911,3077,60408.0,0.166
30525,2019,42330,7078,18915,15590,3325,12409,3181,62228.17,0.168
30528,2010,11270,1321,4302,3860,442,3009,851,56688.0,0.198
30528,2011,11218,1523,4408,3763,645,2929,834,65935.5,0.189
30528,2012,11113,1487,4403,3668,735,2918,750,71236.0,0.17
30528,2013,11285,1546,4464,3862,602,3101,761,67384.0,0.17
30528,2014,11257,1660,4340,3865,475,3245,620,73831.5,0.143
30528,2015,10692,1786,4364,3910,454,3138,772,62284.5,0.177
30528,2016,11646,1834,4336,4155,181,3316,839,62676.0,0.193
30528,2017,11534,1838,4390,4181,209,3404,777,65883.5,0.177
30528,2018,11189,1614,4260,3994,266,3255,739,70060.0,0.173
30528,2019,11783,1611,4456,4193,263,3412,781,68311.0,0.175
30529,2010,75881,7764,32762,27868,4894,20448,7420,43168.31,0.226
30529,2011,76600,7959,32950,27808,5142,20650,7158,45059.62,0.217
30529,2012,78473,8255,33573,28587,4986,21306,7281,45767.25,0.217
30529,2013,77933,8320,33122,28008,5114,20943,7065,46197.31,0.213
30529,2014,77616,8703,32960,27603,5357,20753,6850,45965.19,0.208
30529,2015,77766,8442,33006,27693,5313,20393,7300,47072.88,0.221
30529,2016,78198,8557,32871,27902,4969,20395,7507,48241.62,0.228
30529,2017,77737,8780,33036,27796,5240,20104,7692,49878.94,0.233
30529,2018,78422,8654,33350,28335,5015,20337,7998,52529.06,0.24
30529,2019,79416,8962,33791,29116,4675,20906,8210,56764.56,0.243
30530,2010,55073,7039,23897,20407,3490,15125,5282,51402.0,0.221
30530,2011,55186,7133,23863,20202,3661,15257,4945,54043.0,0.207
30530,2012,57172,7239,24325,20716,3609,15651,5065,56398.27,0.208
30530,2013,56527,7068,23906,20221,3685,15262,4959,56786.0,0.207
30530,2014,56253,7370,23802,19954,3848,15096,4858,54825.73,0.204
30530,2015,56337,7387,23953,20081,3872,14773,5308,57398.64,0.222
30530,2016,56839,7510,23880,20265,3615,14703,5562,59289.45,0.233
30530,2017,57263,7942,23941,20253,3688,14749,5504,62243.09,0.23
30530,2018,57557,8016,24234,20577,3657,14869,5708,65588.18,0.236
30530,2019,58422,8061,24501,21177,3324,15360,5817,68546.36,0.237
30531,2010,5763,3582,4163,3166,997,1852,1314,90271.0,0.316
30531,2011,6212,3772,4450,3341,1109,1939,1402,90522.0,0.315
30531,2012,6163,3726,4482,3262,1220,1797,1465,90024.5,0.327
30531,2013,6295,3705,4486,3175,1311,1734,1441,91901.5,0.321
30531,2014,6801,3865,4585,3239,1346,1759,1480,86944.0,0.323
30531,2015,7063,4209,4607,3380,1227,1773,1607,95878.0,0.349
30531,2016,7298,4324,4685,3602,1083,1994,1608,92268.5,0.343
30531,2017,7377,4236,4718,3637,1081,1958,1679,88803.5,0.356
30531,2018,7227,3993,4720,3660,1060,2017,1643,90368.0,0.348
30531,2019,7266,4170,4819,3862,957,2154,1708,93698.5,0.354
30533,2010,35718,3905,15841,13090,2751,9847,3243,50854.83,0.205
30533,2011,36048,4808,16250,12977,3273,9990,2987,54928.5,0.184
30533,2012,36438,4996,16327,13225,3102,10126,3099,57304.33,0.19
30533,2013,37574,5425,16530,13703,2827,10438,3265,55892.0,0.198
30533,2014,37657,5923,16611,13612,2999,10672,2940,58825.67,0.177
30533,2015,37508,6453,16764,13761,3003,10659,3102,56096.5,0.185
30533,2016,38466,6759,16651,14111,2540,10906,3205,55606.17,0.192
30533,2017,38738,7194,17064,14217,2847,11014,3203,58441.33,0.188
30533,2018,37907,7062,17085,14015,3070,11083,2932,62897.17,0.172
30533,2019,39552,6944,17556,14628,2928,11566,3062,62734.0,0.174
30534,2010,63944,9372,28915,24039,4876,19960,4079,58670.08,0.141
30534,2011,65725,9847,29604,23661,5943,19477,4184,60428.25,0.141
30534,2012,67146,10320,29910,24405,5505,19571,4834,61115.67,0.162
30534,2013,69440,11195,30258,25061,5197,19790,5271,58675.58,0.174
30534,2014,70262,12348,30910,25189,5721,20038,5151,58972.0,0.167
30534,2015,71570,13308,31328,25581,5747,20176,5405,59839.75,0.173
30534,2016,73068,14578,31461,26442,5019,21118,5324,60498.75,0.169
30534,2017,73874,15518,32089,26620,5469,21602,5018,64994.92,0.156
30534,2018,76135,15529,32739,27465,5274,22706,4759,70029.92,0.145
30534,2019,77715,15902,33427,28461,4966,23464,4997,72695.42,0.149
30535,2010,4091,2390,2839,2111,728,1205,906,80417.0,0.319
30535,2011,4448,2497,3139,2284,855,1295,989,74516.0,0.315
30535,2012,4422,2505,3261,2264,997,1244,1020,73913.0,0.313
30535,2013,4636,2564,3279,2227,1052,1190,1037,77865.0,0.316
30535,2014,5159,2781,3415,2365,1050,1234,1131,81615.0,0.331
30535,2015,5471,3181,3472,2567,905,1271,1296,89196.0,0.373
30535,2016,5541,3243,3541,2737,804,1437,1300,92176.0,0.367
30535,2017,5572,3115,3524,2703,821,1387,1316,85750.0,0.373
30535,2018,5317,2816,3539,2662,877,1389,1273,91765.0,0.36
30535,2019,5219,2933,3597,2843,754,1491,1352,90140.0,0.376
30536,2010,22038,3717,11514,8709,2805,6838,1871,52425.75,0.162
30536,2011,22629,4062,11881,8666,3215,6945,1721,54870.0,0.145
30536,2012,22415,4290,11803,8868,2935,7119,1749,54772.0,0.148
30536,2013,23465,4665,11903,9125,2778,7383,1742,54350.75,0.146
30536,2014,23696,4987,12184,9257,2927,7501,1756,53180.0,0.144
30536,2015,24753,5446,12330,9529,2801,7706,1823,55664.25,0.148
30536,2016,24630,5695,12132,9646,2486,7706,1940,54323.5,0.16
30536,2017,25176,5971,12500,9721,2779,7664,2057,59404.75,0.165
30536,2018,24451,5534,12429,9672,2757,7691,1981,60876.5,0.159
30536,2019,25164,5466,12630,10003,2627,8023,1980,62954.0,0.157
30537,2010,25305,2268,11116,9345,1771,7212,2133,44613.75,0.192
30537,2011,26319,2513,11307,9353,1954,7264,2089,45646.5,0.185
30537,2012,25970,2871,11396,9555,1841,7431,2124,46633.0,0.186
30537,2013,26743,3265,11538,9851,1687,7603,2248,47435.0,0.195
30537,2014,26865,3544,11843,9856,1987,7612,2244,48251.75,0.189
30537,2015,27153,3662,11964,9887,2077,7654,2233,49467.5,0.187
30537,2016,26922,4187,11911,10002,1909,7719,2283,49099.75,0.192
30537,2017,27310,4556,12081,10080,2001,7800,2280,51195.5,0.189
30537,2018,27347,4060,12160,10137,2023,7892,2245,53124.25,0.185
30537,2019,27899,4378,12452,10543,1909,8229,2314,56453.5,0.186
30538,2010,10945,803,4723,3964,759,2871,1093,39337.0,0.231
30538,2011,10979,878,4730,3984,746,2825,1159,39211.5,0.245
30538,2012,11425,899,4792,4117,675,3039,1078,40018.0,0.225
30538,2013,10858,829,4687,3910,777,2942,968,40703.5,0.207
30538,2014,11293,1105,4605,3923,682,2959,964,41279.5,0.209
30538,2015,11031,1133,4580,3879,701,2749,1130,40085.5,0.247
30538,2016,11295,1125,4641,3879,762,2827,1052,44623.0,0.227
30538,2017,11713,1187,4645,3853,792,2792,1061,46002.0,0.228
30538,2018,11839,1217,4555,3908,647,2831,1077,48250.0,0.236
30538,2019,11764,1091,4516,3867,649,2884,983,50072.5,0.218
30540,2010,18653,2489,7478,6578,900,4482,2096,40831.67,0.28
30540,2011,18425,2658,7603,6602,1001,4613,1989,46408.0,0.262
30540,2012,18575,2571,7555,6667,888,4584,2083,45903.33,0.276
30540,2013,18076,2513,7282,6389,893,4368,2021,47450.67,0.278
30540,2014,17662,2403,7244,6191,1053,4306,1885,45995.33,0.26
30540,2015,17207,2532,7176,6264,912,4469,1795,50393.0,0.25
30540,2016,17260,2360,7196,6313,883,4287,2026,50172.67,0.282
30540,2017,17672,2559,7466,6486,980,4517,1969,51737.0,0.264
30540,2018,17963,2358,7631,6677,954,4570,2107,55368.0,0.276
30540,2019,17801,2397,7484,6558,926,4525,2033,62604.0,0.272
30541,2010,11046,969,4753,4111,642,2838,1273,43050.0,0.268
30541,2011,10998,953,4685,4097,588,2835,1262,42567.5,0.269
30541,2012,10904,1010,4740,4106,634,2879,1227,44879.0,0.259
30541,2013,10942,1104,4700,3970,730,2799,1171,46536.5,0.249
30541,2014,10808,1138,4645,3874,771,2693,1181,45929.5,0.254
30541,2015,10543,1372,4513,3938,575,2794,1144,48075.0,0.253
30541,2016,10636,1310,4653,4013,640,2758,1255,50474.5,0.27
30541,2017,10763,1252,4706,4170,536,2823,1347,51591.0,0.286
30541,2018,10973,1183,4813,4335,478,2845,1490,52692.0,0.31
30541,2019,11185,1285,4808,4286,522,2886,1400,57881.5,0.291
30543,2010,22543,1656,9611,8181,1430,5843,2338,43031.33,0.243
30543,2011,23109,1697,9808,8302,1506,5921,2381,43818.33,0.243
30543,2012,23021,1973,9959,8550,1409,6199,2351,45426.17,0.236
30543,2013,23244,2256,9923,8494,1429,6235,2259,45645.5,0.228
30543,2014,23216,2378,9916,8407,1509,6233,2174,43790.83,0.219
30543,2015,23337,2161,9807,8343,1464,6191,2152,45826.33,0.219
30543,2016,23365,2245,9833,8433,1400,6265,2168,47030.33,0.22
30543,2017,22550,2069,9935,8328,1607,5935,2393,47985.83,0.241
30543,2018,23006,1951,9961,8557,1404,6069,2488,50645.0,0.25
30543,2019,22991,2093,10093,8676,1417,6096,2580,54053.17,0.256
30546,2010,18452,1581,6847,5945,902,4835,1110,48773.5,0.162
30546,2011,18633,1571,6710,5955,755,4701,1254,50196.0,0.187
30546,2012,19760,1732,7100,6302,798,4816,1486,52207.5,0.209
30546,2013,19465,1730,7033,6282,751,4855,1427,51554.0,0.203
30546,2014,18717,1546,6787,6115,672,4475,1640,49016.5,0.242
30546,2015,18391,1523,6802,6163,639,4247,1916,52556.0,0.282
30546,2016,18056,1405,6937,6317,620,4053,2264,51865.5,0.326
30546,2017,17818,1345,6934,6342,592,4374,1968,51279.0,0.284
30546,2018,17781,1433,7057,6313,744,4363,1950,55250.0,0.276
30546,2019,17551,1426,6939,6244,695,4474,1770,57553.5,0.255
30547,2010,28351,2376,12832,10535,2297,7684,2851,41763.6,0.222
30547,2011,29077,2832,13096,10633,2463,7899,2734,42996.0,0.209
30547,2012,29556,3087,13198,10955,2243,8315,2640,43924.8,0.2
30547,2013,29956,3335,13256,11000,2256,8473,2527,44546.0,0.191
30547,2014,30578,3822,13442,11098,2344,8538,2560,44870.0,0.19
30547,2015,30665,4022,13511,11153,2358,8457,2696,44964.0,0.2
30547,2016,30718,4274,13427,11174,2253,8447,2727,45579.2,0.203
30547,2017,31445,4579,13627,11245,2382,8366,2879,47476.0,0.211
30547,2018,30957,4351,13546,11235,2311,8384,2851,49502.6,0.21
30547,2019,31554,4218,13692,11468,2224,8705,2763,51589.6,0.202
30548,2010,33280,7380,10633,9899,734,8924,975,73872.75,0.092
30548,2011,34486,7935,10866,10123,743,9172,951,69542.75,0.088
30548,2012,35627,8105,11032,10285,747,9202,1083,71676.5,0.098
30548,2013,35683,8297,11241,10392,849,9353,1039,71441.25,0.092
30548,2014,36489,8199,11298,10455,843,9471,984,74226.0,0.087
30548,2015,35833,8734,11657,10698,959,9601,1097,78016.25,0.094
30548,2016,37561,9497,11706,10809,897,9573,1236,85115.75,0.106
30548,2017,37746,9635,11920,11029,891,9823,1206,88266.0,0.101
30548,2018,39514,10356,12316,11681,635,10250,1431,96296.75,0.116
30548,2019,40324,11550,12849,12249,600,10671,1578,98543.75,0.123
30549,2010,24159,2301,10674,9015,1659,6728,2287,42917.0,0.214
30549,2011,24873,2501,10807,9126,1681,7004,2122,44347.33,0.196
30549,2012,25453,2468,11089,9521,1568,7325,2196,46151.0,0.198
30549,2013,25777,2728,11073,9504,1569,7387,2117,47225.5,0.191
30549,2014,26024,2818,11216,9460,1756,7393,2067,49371.83,0.184
30549,2015,26215,2595,11203,9479,1724,7281,2198,50723.5,0.196
30549,2016,26341,2611,11306,9644,1662,7409,2235,51547.5,0.198
30549,2017,25810,2582,11445,9581,1864,7202,2379,53297.83,0.208
30549,2018,25670,2501,11425,9591,1834,7252,2339,54354.0,0.205
30549,2019,26190,2980,11621,9881,1740,7524,2357,58201.83,0.203
30553,2010,10911,799,4196,3678,518,2869,809,42514.0,0.193
30553,2011,10849,875,4153,3701,452,2743,958,42295.0,0.231
30553,2012,11957,918,4491,4021,470,2903,1118,45088.0,0.249
30553,2013,12155,933,4429,4004,425,2878,1126,44905.0,0.254
30553,2014,11791,849,4296,3880,416,2658,1222,45913.0,0.284
30553,2015,11751,710,4316,3900,416,2493,1407,44682.0,0.326
30553,2016,11342,720,4399,4033,366,2311,1722,43181.0,0.391
30553,2017,10651,758,4291,3973,318,2457,1516,42919.0,0.353
30553,2018,11388,971,4557,4156,401,2619,1537,46799.0,0.337
30553,2019,11099,932,4400,4031,369,2627,1404,49531.0,0.319
30554,2010,36374,2775,16186,13394,2792,9417,3977,40287.29,0.246
30554,2011,36961,3238,16449,13451,2998,9590,3861,41793.86,0.235
30554,2012,37120,3656,16515,13674,2841,10017,3657,42589.86,0.221
30554,2013,37398,3948,16564,13708,2856,10161,3547,42879.14,0.214
30554,2014,37607,4503,16682,13809,2873,10215,3594,41248.0,0.215
30554,2015,37703,4633,16674,13790,2884,10083,3707,42592.43,0.222
30554,2016,37809,4860,16611,13805,2806,10090,3715,42881.86,0.224
30554,2017,38236,5043,16862,13867,2995,9950,3917,43842.29,0.232
30554,2018,38222,4741,16893,14064,2829,10059,4005,46904.57,0.237
30554,2019,38856,4534,17056,14261,2795,10328,3933,50372.71,0.231
30555,2010,11046,969,4753,4111,642,2838,1273,43050.0,0.268
30555,2011,10998,953,4685,4097,588,2835,1262,42567.5,0.269
30555,2012,10904,1010,4740,4106,634,2879,1227,44879.0,0.259
30555,2013,10942,1104,4700,3970,730,2799,1171,46536.5,0.249
30555,2014,10808,1138,4645,3874,771,2693,1181,45929.5,0.254
30555,2015,10543,1372,4513,3938,575,2794,1144,48075.0,0.253
30555,2016,10636,1310,4653,4013,640,2758,1255,50474.5,0.27
30555,2017,10763,1252,4706,4170,536,2823,1347,51591.0,0.286
30555,2018,10973,1183,4813,4335,478,2845,1490,52692.0,0.31
30555,2019,11185,1285,4808,4286,522,2886,1400,57881.5,0.291
30557,2010,10945,803,4723,3964,759,2871,1093,39337.0,0.231
30557,2011,10979,878,4730,3984,746,2825,1159,39211.5,0.245
30557,2012,11425,899,4792,4117,675,3039,1078,40018.0,0.225
30557,2013,10858,829,4687,3910,777,2942,968,40703.5,0.207
30557,2014,11293,1105,4605,3923,682,2959,964,41279.5,0.209
30557,2015,11031,1133,4580,3879,701,2749,1130,40085.5,0.247
30557,2016,11295,1125,4641,3879,762,2827,1052,44623.0,0.227
30557,2017,11713,1187,4645,3853,792,2792,1061,46002.0,0.228
30557,2018,11839,1217,4555,3908,647,2831,1077,48250.0,0.236
30557,2019,11764,1091,4516,3867,649,2884,983,50072.5,0.218
30558,2010,45488,4271,18888,16250,2638,11674,4576,42311.6,0.242
30558,2011,45789,4523,19192,16352,2840,11798,4554,44426.5,0.237
30558,2012,46319,4712,19346,16774,2572,12245,4529,45351.7,0.234
30558,2013,45567,4784,19020,16341,2679,12036,4305,45885.5,0.226
30558,2014,45974,5160,18972,16210,2762,12113,4097,44345.7,0.216
30558,2015,45309,4908,18910,16079,2831,11883,4196,46020.1,0.222
30558,2016,45706,4865,18934,16227,2707,11954,4273,47065.1,0.226
30558,2017,45613,4927,19206,16145,3061,11734,4411,48459.0,0.23
30558,2018,46288,4682,19171,16458,2713,11895,4563,51448.3,0.238
30558,2019,45965,4649,19138,16478,2660,11870,4608,55495.1,0.241
30559,2010,19195,3549,9376,7386,1990,5792,1594,54512.0,0.17
30559,2011,19397,3604,9504,7377,2127,5692,1685,54235.75,0.177
30559,2012,19080,3683,9421,7432,1989,5659,1773,54221.25,0.188
30559,2013,19016,3781,9255,7256,1999,5534,1722,53185.0,0.186
30559,2014,18787,3907,9222,7192,2030,5466,1726,52699.5,0.187
30559,2015,19722,4304,9260,7570,1690,5772,1798,56013.25,0.194
30559,2016,19682,4242,9320,7671,1649,5764,1907,57927.75,0.205
30559,2017,20116,4333,9567,7746,1821,5899,1847,64708.5,0.193
30559,2018,20033,4136,9598,7967,1631,5919,2048,66595.5,0.213
30559,2019,20683,4150,9703,8051,1652,6015,2036,68886.25,0.21
30560,2010,9044,2708,5106,3639,1467,3173,466,70203.0,0.091
30560,2011,8854,2678,5181,3526,1655,3023,503,68930.5,0.097
30560,2012,8637,2690,5078,3572,1506,3051,521,68440.5,0.103
30560,2013,8516,2694,5014,3503,1511,3032,471,65219.5,0.094
30560,2014,8762,2845,5050,3591,1459,3062,529,64132.5,0.105
30560,2015,9499,3019,5127,3797,1330,3186,611,68297.5,0.119
30560,2016,9796,3038,5135,3945,1190,3317,628,67579.5,0.122
30560,2017,10107,3055,5320,3934,1386,3368,566,77718.5,0.106
30560,2018,9620,2889,5167,3945,1222,3325,620,76019.0,0.12
30560,2019,10064,2797,5257,4066,1191,3405,661,76779.0,0.126
30562,2010,17406,1573,8109,6571,1538,4813,1758,43381.33,0.217
30562,2011,18098,1954,8366,6649,1717,5074,1575,45519.0,0.188
30562,2012,18131,2188,8406,6838,1568,5276,1562,46529.33,0.186
30562,2013,19098,2506,8569,7090,1479,5531,1559,47107.67,0.182
30562,2014,19285,2717,8837,7175,1662,5579,1596,47263.67,0.181
30562,2015,19634,2889,8931,7274,1657,5708,1566,48216.33,0.175
30562,2016,19423,3149,8786,7295,1491,5620,1675,46216.67,0.191
30562,2017,19732,3392,8982,7392,1590,5574,1818,48458.67,0.202
30562,2018,19118,3134,8991,7327,1664,5553,1774,50337.67,0.197
30562,2019,19790,3127,9176,7601,1575,5821,1780,52601.0,0.194
30563,2010,10196,6118,6373,5189,1184,3540,1649,98488.0,0.259
30563,2011,10539,6293,6567,5237,1330,3478,1759,102278.67,0.268
30563,2012,10388,6073,6537,5110,1427,3276,1834,101241.67,0.281
30563,2013,10614,6041,6503,5052,1451,3278,1774,103207.33,0.273
30563,2014,11270,6259,6591,5046,1545,3263,1783,100822.0,0.271
30563,2015,11713,6856,6651,5227,1424,3294,1933,110414.33,0.291
30563,2016,12079,6957,6730,5458,1272,3503,1955,107604.33,0.29
30563,2017,12560,7134,6816,5606,1210,3532,2074,109019.0,0.304
30563,2018,12600,6960,6871,5657,1214,3551,2106,111882.33,0.307
30563,2019,12676,7312,6959,5946,1013,3726,2220,118597.67,0.319
30564,2010,1377,238,699,538,161,425,113,53452.0,0.162
30564,2011,1470,414,689,562,127,465,97,70690.0,0.141
30564,2012,1627,459,732,558,174,488,70,78833.0,0.096
30564,2013,1657,406,736,583,153,515,68,74848.0,0.092
30564,2014,1573,327,719,579,140,492,87,82688.0,0.121
30564,2015,1474,262,731,610,121,470,140,59741.0,0.192
30564,2016,1573,187,706,634,72,480,154,57713.0,0.218
30564,2017,1461,216,716,627,89,458,169,63594.0,0.236
30564,2018,1379,278,700,603,97,474,129,72841.0,0.184
30564,2019,1487,190,688,602,86,479,123,63125.0,0.179
30565,2010,14028,2607,6789,5612,1177,3770,1842,63775.75,0.271
30565,2011,14004,2654,6751,5603,1148,3940,1663,64033.0,0.246
30565,2012,14589,2777,6895,5718,1177,4036,1682,70653.0,0.244
30565,2013,14647,2869,6952,5815,1137,4039,1776,71387.0,0.255
30565,2014,14612,3077,7111,5893,1218,4105,1788,68504.25,0.251
30565,2015,14739,3120,7120,5894,1226,4003,1891,74411.25,0.266
30565,2016,15218,3162,7379,6121,1258,4071,2050,76710.0,0.278
30565,2017,15432,3428,7466,6134,1332,4224,1910,82780.5,0.256
30565,2018,15316,3340,7557,6174,1383,4182,1992,84552.0,0.264
30565,2019,15659,3745,7533,6248,1285,4418,1830,88835.75,0.243
30567,2010,21125,5297,11911,10023,1888,6231,3792,51112.0,0.318
30567,2011,22327,5657,12349,10343,2006,6377,3966,50944.67,0.321
30567,2012,22484,5870,12559,10709,1850,6612,4097,52284.33,0.326
30567,2013,22928,6400,12508,10763,1745,6567,4196,52554.5,0.335
30567,2014,23189,6393,12649,10762,1887,6666,4096,53713.17,0.324
30567,2015,24100,6669,12763,11011,1752,6772,4239,54931.33,0.332
30567,2016,24129,6868,12806,11281,1525,6883,4398,56816.17,0.343
30567,2017,23930,7058,13039,11331,1708,6607,4724,60010.83,0.362
30567,2018,24603,7301,13266,11598,1668,6677,4921,60885.5,0.371
30567,2019,25422,8026,13719,12183,1536,6811,5372,67212.83,0.392
30568,2010,24448,2584,11539,9230,2309,6838,2392,47938.25,0.207
30568,2011,24830,3285,11842,9214,2628,7061,2153,49425.0,0.182
30568,2012,25325,3509,11924,9557,2367,7208,2349,50338.5,0.197
30568,2013,26289,3879,12066,9841,2225,7337,2504,50146.0,0.208
30568,2014,26400,4263,12271,9747,2524,7427,2320,51322.75,0.189
30568,2015,26816,4667,12400,9851,2549,7521,2330,53002.5,0.188
30568,2016,26820,4925,12315,9956,2359,7590,2366,52071.25,0.192
30568,2017,27204,5356,12674,10036,2638,7610,2426,54720.25,0.191
30568,2018,26718,5448,12825,10021,2804,7828,2193,59315.75,0.171
30568,2019,27769,5333,13100,10435,2665,8154,2281,59945.5,0.174
30572,2010,4412,564,1701,1501,200,1148,353,60847.0,0.208
30572,2011,4323,570,1666,1509,157,1152,357,54938.0,0.214
30572,2012,4353,588,1681,1542,139,1208,334,57381.0,0.199
30572,2013,4149,535,1680,1468,212,1180,288,54359.0,0.171
30572,2014,4351,575,1703,1509,194,1140,369,57336.0,0.217
30572,2015,4380,462,1728,1542,186,1188,354,58587.0,0.205
30572,2016,4589,492,1789,1594,195,1231,363,56515.0,0.203
30572,2017,4663,476,1802,1605,197,1278,327,63194.0,0.181
30572,2018,4287,489,1729,1600,129,1187,413,59545.0,0.239
30572,2019,4690,458,1803,1664,139,1203,461,59545.0,0.256
30575,2010,3445,2177,3028,2424,604,1231,1193,72063.0,0.394
30575,2011,3584,2353,3184,2457,727,1202,1255,64747.0,0.394
30575,2012,3475,2432,3230,2475,755,1186,1289,63314.0,0.399
30575,2013,3501,2602,3235,2549,686,1132,1417,65255.0,0.438
30575,2014,3518,2560,3254,2623,631,1165,1458,66670.0,0.448
30575,2015,3898,2693,3376,2771,605,1237,1534,68117.0,0.454
30575,2016,4119,2912,3392,2927,465,1389,1538,75195.0,0.453
30575,2017,4141,3014,3470,2945,525,1451,1494,83063.0,0.431
30575,2018,4597,3124,3812,3153,659,1537,1616,82188.0,0.424
30575,2019,5206,3393,4068,3412,656,1621,1791,93143.0,0.44
30576,2010,7042,1011,3430,2659,771,2025,634,61609.0,0.185
30576,2011,6732,1331,3476,2565,911,1987,578,61143.0,0.166
30576,2012,7194,1321,3518,2719,799,1932,787,61766.0,0.224
30576,2013,7191,1373,3497,2751,746,1806,945,59261.0,0.27
30576,2014,7115,1546,3434,2572,862,1848,724,63500.0,0.211
30576,2015,7182,1778,3469,2577,892,1813,764,67361.0,0.22
30576,2016,7397,1776,3529,2661,868,1970,691,69635.0,0.196
30576,2017,7472,1964,3692,2644,1048,2036,608,73505.0,0.165
30576,2018,7600,2314,3834,2694,1140,2275,419,86250.0,0.109
30576,2019,7979,2206,3924,2834,1090,2333,501,81979.0,0.128
30577,2010,51862,7677,24475,20184,4291,14832,5352,55400.9,0.219
30577,2011,53266,8582,24890,20235,4655,15156,5079,58385.7,0.204
30577,2012,53653,8843,24880,20639,4241,15623,5016,58902.4,0.202
30577,2013,55032,9318,25049,20915,4134,16092,4823,59581.0,0.193
30577,2014,55974,10017,25455,20954,4501,16146,4808,58699.2,0.189
30577,2015,56541,10586,25621,21087,4534,16188,4899,61151.6,0.191
30577,2016,56679,11137,25402,21190,4212,16133,5057,59718.3,0.199
30577,2017,58165,11990,25901,21540,4361,16085,5455,62406.3,0.211
30577,2018,57358,11629,25869,21557,4312,16099,5458,64240.8,0.211
30577,2019,58801,11724,26230,22172,4058,16761,5411,68140.4,0.206
30580,2010,4433,2536,2210,2023,187,1688,335,114922.0,0.152
30580,2011,4327,2521,2117,1896,221,1539,357,125792.0,0.169
30580,2012,4225,2347,2055,1848,207,1479,369,123676.0,0.18
30580,2013,4319,2336,2017,1877,140,1544,333,125819.0,0.165
30580,2014,4469,2394,2006,1807,199,1504,303,128578.0,0.151
30580,2015,4650,2647,2044,1847,197,1521,326,139487.0,0.159
30580,2016,4781,2633,2045,1856,189,1509,347,138276.0,0.17
30580,2017,5183,2898,2098,1969,129,1574,395,149450.0,0.188
30580,2018,5373,2967,2151,1997,154,1534,463,154911.0,0.215
30580,2019,5410,3142,2140,2084,56,1572,512,168396.0,0.239
30582,2010,10911,799,4196,3678,518,2869,809,42514.0,0.193
30582,2011,10849,875,4153,3701,452,2743,958,42295.0,0.231
30582,2012,11957,918,4491,4021,470,2903,1118,45088.0,0.249
30582,2013,12155,933,4429,4004,425,2878,1126,44905.0,0.254
30582,2014,11791,849,4296,3880,416,2658,1222,45913.0,0.284
30582,2015,11751,710,4316,3900,416,2493,1407,44682.0,0.326
30582,2016,11342,720,4399,4033,366,2311,1722,43181.0,0.391
30582,2017,10651,758,4291,3973,318,2457,1516,42919.0,0.353
30582,2018,11388,971,4557,4156,401,2619,1537,46799.0,0.337
30582,2019,11099,932,4400,4031,369,2627,1404,49531.0,0.319
30598,2010,17406,1573,8109,6571,1538,4813,1758,43381.33,0.217
30598,2011,18098,1954,8366,6649,1717,5074,1575,45519.0,0.188
30598,2012,18131,2188,8406,6838,1568,5276,1562,46529.33,0.186
30598,2013,19098,2506,8569,7090,1479,5531,1559,47107.67,0.182
30598,2014,19285,2717,8837,7175,1662,5579,1596,47263.67,0.181
30598,2015,19634,2889,8931,7274,1657,5708,1566,48216.33,0.175
30598,2016,19423,3149,8786,7295,1491,5620,1675,46216.67,0.191
30598,2017,19732,3392,8982,7392,1590,5574,1818,48458.67,0.202
30598,2018,19118,3134,8991,7327,1664,5553,1774,50337.67,0.197
30598,2019,19790,3127,9176,7601,1575,5821,1780,52601.0,0.194
30599,2010,12000,1812,4554,4105,449,2960,1145,43127.0,0.251
30599,2011,11701,1948,4654,4066,588,3052,1014,51466.0,0.218
30599,2012,11873,1840,4595,4107,488,3007,1100,50462.0,0.239
30599,2013,11465,1699,4410,3937,473,2859,1078,51787.5,0.244
30599,2014,11465,1677,4451,3880,571,2921,959,49076.5,0.215
30599,2015,10941,1614,4523,3857,666,2943,914,52536.0,0.202
30599,2016,11046,1495,4460,3915,545,2862,1053,49611.5,0.236
30599,2017,11350,1671,4626,3964,662,3007,957,52335.5,0.207
30599,2018,11443,1514,4655,3993,662,2995,998,57056.5,0.214
30599,2019,11210,1465,4529,3935,594,2890,1045,65243.5,0.231
30601,2010,25695,7839,13441,10811,2630,6230,4581,57093.43,0.341
30601,2011,27400,8346,13849,11079,2770,6385,4694,59297.29,0.339
30601,2012,29206,7918,14196,11297,2899,6406,4891,58234.0,0.345
30601,2013,29317,8196,14183,11426,2757,6525,4901,61435.86,0.346
30601,2014,30456,8721,14388,11564,2824,6516,5048,64573.71,0.351
30601,2015,30949,8980,14463,11711,2752,6462,5249,65724.43,0.363
30601,2016,31981,9363,14633,11946,2687,6547,5399,66123.29,0.369
30601,2017,32651,10370,15029,12377,2652,6911,5466,71131.14,0.364
30601,2018,33839,10386,15395,12685,2710,6878,5807,72032.71,0.377
30601,2019,34789,11341,15614,13234,2380,7411,5823,82298.29,0.373
30602,2010,24367,6308,10403,9008,1395,4538,4470,56787.4,0.43
30602,2011,25232,6594,10937,9380,1557,4666,4714,60678.6,0.431
30602,2012,25254,6282,11096,9371,1725,4495,4876,56532.8,0.439
30602,2013,25247,6547,11195,9574,1621,4641,4933,58790.2,0.441
30602,2014,25727,6807,11436,9733,1703,4651,5082,58010.4,0.444
30602,2015,25440,6937,11505,9839,1666,4430,5409,59921.6,0.47
30602,2016,25718,7256,11534,9844,1690,4326,5518,58992.2,0.478
30602,2017,26022,8175,11781,10220,1561,4765,5455,67465.6,0.463
30602,2018,27260,8463,12227,10729,1498,4839,5890,68472.2,0.482
30602,2019,27814,9340,12366,11061,1305,5124,5937,76739.4,0.48
30603,2010,4433,2536,2210,2023,187,1688,335,114922.0,0.152
30603,2011,4327,2521,2117,1896,221,1539,357,125792.0,0.169
30603,2012,4225,2347,2055,1848,207,1479,369,123676.0,0.18
30603,2013,4319,2336,2017,1877,140,1544,333,125819.0,0.165
30603,2014,4469,2394,2006,1807,199,1504,303,128578.0,0.151
30603,2015,4650,2647,2044,1847,197,1521,326,139487.0,0.159
30603,2016,4781,2633,2045,1856,189,1509,347,138276.0,0.17
30603,2017,5183,2898,2098,1969,129,1574,395,149450.0,0.188
30603,2018,5373,2967,2151,1997,154,1534,463,154911.0,0.215
30603,2019,5410,3142,2140,2084,56,1572,512,168396.0,0.239
30605,2010,8425,2172,3105,2462,643,503,1959,36781.5,0.631
30605,2011,9436,2351,3623,2903,720,740,2163,38959.5,0.597
30605,2012,9629,2242,3762,3007,755,688,2319,34891.0,0.616
30605,2013,9033,2361,3755,2979,776,706,2273,39410.0,0.605
30605,2014,9267,2502,3926,3086,840,720,2366,38445.5,0.603
30605,2015,8691,2175,3928,3092,836,651,2441,40386.5,0.621
30605,2016,8821,2472,3905,3010,895,648,2362,41311.0,0.605
30605,2017,8990,3042,4159,3254,905,836,2418,51109.5,0.581
30605,2018,10109,3261,4429,3604,825,841,2763,50822.5,0.624
30605,2019,10361,3582,4627,3879,748,967,2912,61152.0,0.629
30606,2010,24561,5448,11893,9522,2371,3475,6047,40227.17,0.508
30606,2011,26010,5829,12596,10070,2526,3728,6342,41295.83,0.503
30606,2012,26980,5489,12889,10069,2820,3618,6451,37899.0,0.501
30606,2013,27952,6209,13156,10504,2652,3803,6701,42012.83,0.509
30606,2014,28933,6585,13484,10921,2563,3864,7057,41380.83,0.523
30606,2015,29498,6947,13607,11235,2372,3731,7504,43460.83,0.551
30606,2016,30449,7683,13764,11454,2310,3707,7747,44954.33,0.563
30606,2017,30466,8751,14126,11893,2233,4126,7767,51694.83,0.55
30606,2018,31361,9132,14580,12406,2174,4287,8119,53397.17,0.557
30606,2019,32379,10384,15075,13022,2053,4690,8332,62117.83,0.553
30607,2010,9639,1044,4417,3693,724,2618,1075,36253.5,0.243
30607,2011,9648,1210,4352,3642,710,2774,868,40375.5,0.199
30607,2012,9996,1064,4447,3690,757,2828,862,41427.0,0.194
30607,2013,9975,1085,4458,3718,740,2840,878,43452.0,0.197
30607,2014,9837,1121,4540,3764,776,2837,927,48936.0,0.204
30607,2015,9916,1045,4559,3773,786,2716,1057,51355.0,0.232
30607,2016,10067,952,4657,3842,815,2787,1055,49690.0,0.227
30607,2017,10051,977,4745,3875,870,2851,1024,50694.0,0.216
30607,2018,9929,940,4811,3863,948,2858,1005,51536.5,0.209
30607,2019,10501,1203,4892,3998,894,3051,947,59776.5,0.194
30609,2010,4100,789,1252,1027,225,237,790,26438.0,0.631
30609,2011,3807,706,1218,1024,194,319,705,30662.0,0.579
30609,2012,3308,654,1132,958,174,266,692,27447.0,0.611
30609,2013,2931,690,1044,870,174,307,563,35250.0,0.539
30609,2014,2851,727,1090,907,183,319,588,32279.0,0.539
30609,2015,2785,700,1093,960,133,344,616,37627.0,0.564
30609,2016,2587,579,1089,904,185,322,582,38068.0,0.534
30609,2017,2640,630,1113,871,242,360,511,51250.0,0.459
30609,2018,2463,566,1144,878,266,314,564,47917.0,0.493
30609,2019,2409,658,1156,885,271,378,507,68618.0,0.439
30619,2010,7541,782,2651,2267,384,1966,301,55033.0,0.114
30619,2011,7784,696,2557,2254,303,1958,296,58097.0,0.116
30619,2012,7803,814,2609,2281,328,1913,368,59327.0,0.141
30619,2013,7310,797,2604,2278,326,1977,301,58203.0,0.116
30619,2014,6926,697,2491,2235,256,1817,418,52120.0,0.168
30619,2015,6640,813,2486,2263,223,1754,509,60430.0,0.205
30619,2016,6714,685,2538,2284,254,1742,542,60550.0,0.214
30619,2017,7167,587,2643,2369,274,1917,452,59639.0,0.171
30619,2018,6393,462,2500,2157,343,1744,413,63701.0,0.165
30619,2019,6452,494,2539,2213,326,1847,366,65576.0,0.144
30620,2010,35304,4413,12960,12044,916,10830,1214,56206.6,0.094
30620,2011,38129,5109,13767,12884,883,11352,1532,58102.4,0.111
30620,2012,39203,5140,13649,12638,1011,11008,1630,57560.4,0.119
30620,2013,39773,5701,13858,12878,980,11249,1629,57418.0,0.118
30620,2014,41943,6071,14190,13244,946,11390,1854,60219.2,0.131
30620,2015,42085,5732,14115,13143,972,10933,2210,58237.0,0.157
30620,2016,42200,5984,14483,13383,1100,11088,2295,58288.8,0.158
30620,2017,44046,6676,14809,13812,997,11681,2131,64363.0,0.144
30620,2018,46139,7267,15398,14397,1001,11816,2581,69094.8,0.168
30620,2019,46257,7499,15922,14927,995,12518,2409,74220.8,0.151
30621,2010,15817,1526,6075,5368,707,4202,1166,46667.0,0.192
30621,2011,15993,1919,6289,5573,716,4363,1210,47577.75,0.192
30621,2012,15723,1794,6323,5565,758,4397,1168,45782.75,0.185
30621,2013,15715,1779,6397,5744,653,4529,1215,45100.5,0.19
30621,2014,15800,1733,6360,5754,606,4524,1230,44910.0,0.193
30621,2015,15567,1662,6328,5708,620,4523,1185,45964.5,0.187
30621,2016,15624,1347,6312,5700,612,4518,1182,43475.0,0.187
30621,2017,15876,1453,6365,5796,569,4512,1284,49000.25,0.202
30621,2018,16585,1538,6529,5914,615,4662,1252,53260.75,0.192
30621,2019,16335,1702,6496,5822,674,4678,1144,58714.75,0.176
30622,2010,5947,526,2339,2120,219,1652,468,45116.0,0.2
30622,2011,6026,552,2372,2118,254,1631,487,46179.0,0.205
30622,2012,5924,521,2290,2004,286,1612,392,45606.0,0.171
30622,2013,6273,556,2194,1927,267,1442,485,48951.0,0.221
30622,2014,6246,516,2205,1895,310,1379,516,49338.0,0.234
30622,2015,6093,500,2225,1862,363,1302,560,48281.0,0.252
30622,2016,6546,583,2430,2104,326,1530,574,50900.0,0.236
30622,2017,6602,549,2321,2058,263,1371,687,55313.0,0.296
30622,2018,6689,526,2582,2355,227,1626,729,52440.0,0.282
30622,2019,6930,775,2467,2251,216,1517,734,62667.0,0.298
30623,2010,15817,1526,6075,5368,707,4202,1166,46667.0,0.192
30623,2011,15993,1919,6289,5573,716,4363,1210,47577.75,0.192
30623,2012,15723,1794,6323,5565,758,4397,1168,45782.75,0.185
30623,2013,15715,1779,6397,5744,653,4529,1215,45100.5,0.19
30623,2014,15800,1733,6360,5754,606,4524,1230,44910.0,0.193
30623,2015,15567,1662,6328,5708,620,4523,1185,45964.5,0.187
30623,2016,15624,1347,6312,5700,612,4518,1182,43475.0,0.187
30623,2017,15876,1453,6365,5796,569,4512,1284,49000.25,0.202
30623,2018,16585,1538,6529,5914,615,4662,1252,53260.75,0.192
30623,2019,16335,1702,6496,5822,674,4678,1144,58714.75,0.176
30624,2010,13736,3781,5966,5187,779,4135,1052,71317.0,0.176
30624,2011,13814,3598,5710,4976,734,3900,1076,73773.67,0.188
30624,2012,13715,3641,5651,4909,742,3769,1140,74212.33,0.202
30624,2013,13231,3631,5627,4962,665,3904,1058,74580.0,0.188
30624,2014,13262,3642,5498,4893,605,3671,1222,73119.67,0.222
30624,2015,13339,4126,5572,5060,512,3657,1403,79456.33,0.252
30624,2016,13685,3989,5707,5173,534,3585,1588,78578.0,0.278
30624,2017,14452,4238,5885,5314,571,3866,1448,84128.0,0.246
30624,2018,13693,4148,5766,5090,676,3661,1429,91449.0,0.248
30624,2019,13912,4416,5849,5260,589,3873,1387,99095.0,0.237
30625,2010,30647,3532,13060,11247,1813,8740,2507,50998.8,0.192
30625,2011,30911,3335,13125,11015,2110,8542,2473,51423.8,0.188
30625,2012,31644,3507,13451,11233,2218,8663,2570,51908.8,0.191
30625,2013,32019,3591,13372,11228,2144,8653,2575,50663.6,0.193
30625,2014,31489,3755,13069,10915,2154,8556,2359,51817.8,0.181
30625,2015,31759,4013,13170,11141,2029,8462,2679,51016.6,0.203
30625,2016,32498,4387,12910,11354,1556,8490,2864,53894.8,0.222
30625,2017,32146,4498,12759,11330,1429,8465,2865,56051.6,0.225
30625,2018,32015,4368,12928,11405,1523,8365,3040,58037.6,0.235
30625,2019,33246,4531,13529,12231,1298,8918,3313,61445.2,0.245
30627,2010,3822,2038,1676,1516,160,1153,363,105000.0,0.217
30627,2011,3828,2037,1655,1517,138,1060,457,99549.0,0.276
30627,2012,3730,2030,1640,1513,127,1028,485,100506.0,0.296
30627,2013,3833,2114,1669,1525,144,1043,482,104311.0,0.289
30627,2014,3767,2108,1657,1507,150,1025,482,103722.0,0.291
30627,2015,3819,2227,1704,1571,133,1043,528,101875.0,0.31
30627,2016,4056,2283,1758,1630,128,1151,479,101923.0,0.272
30627,2017,4151,2344,1763,1660,103,1192,468,113088.0,0.265
30627,2018,4283,2360,1736,1636,100,1199,437,127019.0,0.252
30627,2019,4476,2415,1725,1675,50,1264,411,147614.0,0.238
30628,2010,9046,4047,4652,3899,753,2586,1313,77564.67,0.282
30628,2011,9029,4031,4634,3940,694,2452,1488,73438.33,0.321
30628,2012,9167,4218,4666,4020,646,2436,1584,73880.0,0.339
30628,2013,9095,4372,4717,4069,648,2407,1662,75657.0,0.352
30628,2014,9140,4562,4727,4047,680,2412,1635,77734.0,0.346
30628,2015,9319,4840,4808,4195,613,2501,1694,74176.67,0.352
30628,2016,9721,4929,4993,4425,568,2625,1800,74627.67,0.361
30628,2017,10030,5148,5005,4428,577,2730,1698,82325.67,0.339
30628,2018,10114,4990,5002,4417,585,2694,1723,86720.33,0.344
30628,2019,10338,5351,4905,4433,472,2922,1511,106470.33,0.308
30629,2010,8415,4524,4277,3823,454,2542,1281,83284.33,0.3
30629,2011,8467,4653,4163,3767,396,2376,1391,83080.67,0.334
30629,2012,8359,4659,4135,3739,396,2303,1436,85552.33,0.347
30629,2013,8342,4779,4078,3674,404,2296,1378,88992.67,0.338
30629,2014,8258,4875,4069,3656,413,2239,1417,91647.33,0.348
30629,2015,8493,5109,4185,3830,355,2356,1474,94533.67,0.352
30629,2016,8715,5176,4303,3936,367,2491,1445,91577.33,0.336
30629,2017,8770,5199,4277,3938,339,2519,1419,93219.33,0.332
30629,2018,8767,5115,4246,3875,371,2509,1366,98248.33,0.322
30629,2019,9058,5292,4202,3903,299,2676,1227,112861.33,0.292
30630,2010,7541,782,2651,2267,384,1966,301,55033.0,0.114
30630,2011,7784,696,2557,2254,303,1958,296,58097.0,0.116
30630,2012,7803,814,2609,2281,328,1913,368,59327.0,0.141
30630,2013,7310,797,2604,2278,326,1977,301,58203.0,0.116
30630,2014,6926,697,2491,2235,256,1817,418,52120.0,0.168
30630,2015,6640,813,2486,2263,223,1754,509,60430.0,0.205
30630,2016,6714,685,2538,2284,254,1742,542,60550.0,0.214
30630,2017,7167,587,2643,2369,274,1917,452,59639.0,0.171
30630,2018,6393,462,2500,2157,343,1744,413,63701.0,0.165
30630,2019,6452,494,2539,2213,326,1847,366,65576.0,0.144
30631,2010,14520,1257,6257,5322,935,4110,1212,46248.75,0.194
30631,2011,15225,1291,6455,5484,971,4230,1254,46333.25,0.194
30631,2012,15457,1404,6642,5831,811,4497,1334,48513.0,0.201
30631,2013,15802,1643,6615,5786,829,4547,1239,49112.25,0.187
30631,2014,16187,1697,6676,5696,980,4556,1140,49589.75,0.171
30631,2015,16299,1550,6644,5706,938,4565,1141,50407.75,0.172
30631,2016,16274,1659,6649,5802,847,4622,1180,52476.25,0.177
30631,2017,15759,1605,6700,5706,994,4351,1355,54599.75,0.202
30631,2018,15741,1561,6614,5728,886,4394,1334,55762.75,0.202
30631,2019,15689,1777,6729,5883,846,4473,1410,57414.5,0.21
30633,2010,14566,6550,7754,6639,1115,4175,2464,79407.5,0.318
30633,2011,14526,6478,7598,6554,1044,3945,2609,77009.17,0.343
30633,2012,14639,6852,7570,6547,1023,3888,2659,82674.83,0.351
30633,2013,14616,7061,7578,6578,1000,3878,2700,84223.33,0.356
30633,2014,14900,7382,7641,6636,1005,3857,2779,81624.67,0.364
30633,2015,15365,7850,7788,6901,887,4025,2876,86164.67,0.369
30633,2016,16056,8057,8149,7248,901,4109,3139,86516.67,0.385
30633,2017,16253,8403,8142,7173,969,4267,2906,92114.5,0.357
30633,2018,16081,8234,8107,7122,985,4216,2906,97602.5,0.358
30633,2019,16266,8614,8013,7116,897,4497,2619,106281.17,0.327
30634,2010,17778,6299,8083,7309,774,5189,2120,81437.33,0.262
30634,2011,17362,6369,8067,7180,887,5010,2170,83255.0,0.269
30634,2012,17646,5980,8026,7238,788,4747,2491,84214.33,0.31
30634,2013,18365,6228,8024,7386,638,4785,2601,86865.0,0.324
30634,2014,18504,6663,8040,7350,690,4861,2489,90047.67,0.31
30634,2015,19090,7207,8078,7649,429,5077,2572,94286.33,0.318
30634,2016,19112,7244,8020,7542,478,5011,2531,96878.0,0.316
30634,2017,19877,7589,8055,7584,471,5053,2531,106133.67,0.314
30634,2018,19944,7806,8061,7552,509,5057,2495,113449.33,0.31
30634,2019,19956,7703,7991,7555,436,5160,2395,129707.67,0.3
30635,2010,19108,7345,10036,8452,1584,5353,3099,77483.0,0.309
30635,2011,19247,7620,10400,8625,1775,5410,3215,76254.25,0.309
30635,2012,19584,7359,10453,8652,1801,5065,3587,77254.0,0.343
30635,2013,20341,7597,10493,8684,1809,4975,3709,79644.75,0.353
30635,2014,20836,8134,10619,8782,1837,5116,3666,78863.25,0.345
30635,2015,21503,8769,10641,9182,1459,5329,3853,83782.0,0.362
30635,2016,21629,8935,10660,9288,1372,5496,3792,84223.75,0.356
30635,2017,22071,8927,10675,9252,1423,5437,3815,86639.5,0.357
30635,2018,21798,8832,10630,9215,1415,5540,3675,91543.25,0.346
30635,2019,21812,8731,10670,9333,1337,5742,3591,102031.0,0.337
30641,2010,20206,2104,7891,7034,857,5488,1546,48448.4,0.196
30641,2011,20162,2378,8075,7158,917,5620,1538,49273.8,0.19
30641,2012,19874,2372,8064,7103,961,5628,1475,48151.2,0.183
30641,2013,20155,2431,8182,7300,882,5815,1485,48080.4,0.181
30641,2014,20015,2288,8139,7319,820,5783,1536,47621.4,0.189
30641,2015,19792,2217,8157,7307,850,5804,1503,47062.2,0.184
30641,2016,20108,1968,8219,7408,811,5870,1538,44595.8,0.187
30641,2017,20262,2028,8287,7514,773,5870,1644,48510.8,0.198
30641,2018,21140,2167,8513,7693,820,6051,1642,52172.4,0.193
30641,2019,21318,2443,8566,7711,855,6212,1499,58379.0,0.175
30642,2010,12000,1812,4554,4105,449,2960,1145,43127.0,0.251
30642,2011,11701,1948,4654,4066,588,3052,1014,51466.0,0.218
30642,2012,11873,1840,4595,4107,488,3007,1100,50462.0,0.239
30642,2013,11465,1699,4410,3937,473,2859,1078,51787.5,0.244
30642,2014,11465,1677,4451,3880,571,2921,959,49076.5,0.215
30642,2015,10941,1614,4523,3857,666,2943,914,52536.0,0.202
30642,2016,11046,1495,4460,3915,545,2862,1053,49611.5,0.236
30642,2017,11350,1671,4626,3964,662,3007,957,52335.5,0.207
30642,2018,11443,1514,4655,3993,662,2995,998,57056.5,0.214
30642,2019,11210,1465,4529,3935,594,2890,1045,65243.5,0.231
30643,2010,18115,1107,6966,6065,901,4587,1478,41941.5,0.212
30643,2011,18150,1286,7051,6252,799,4472,1780,41431.0,0.252
30643,2012,19571,1235,7479,6700,779,4478,2222,42678.5,0.297
30643,2013,20120,1294,7450,6734,716,4308,2426,42778.0,0.326
30643,2014,19725,1536,7347,6669,678,4130,2539,43189.0,0.346
30643,2015,19913,1424,7335,6777,558,4017,2760,43534.5,0.376
30643,2016,19398,1448,7389,6822,567,3836,2986,44747.0,0.404
30643,2017,19063,1630,7377,6811,566,3991,2820,47888.0,0.382
30643,2018,19668,1930,7632,6985,647,4279,2706,52032.5,0.355
30643,2019,19470,1653,7445,6806,639,4274,2532,56123.5,0.34
30646,2010,16598,3984,8139,6796,1343,4571,2225,66623.6,0.273
30646,2011,16544,4075,8052,6761,1291,4694,2067,67589.2,0.257
30646,2012,17153,4209,8184,6876,1308,4780,2096,72930.0,0.256
30646,2013,17075,4347,8213,6969,1244,4758,2211,73785.2,0.269
30646,2014,17063,4620,8368,7062,1306,4800,2262,71547.4,0.27
30646,2015,17324,4764,8417,7128,1289,4745,2383,75308.4,0.283
30646,2016,17738,4796,8734,7433,1301,4834,2599,76768.0,0.298
30646,2017,18006,5012,8827,7428,1399,4969,2459,81960.6,0.279
30646,2018,17901,4883,8922,7443,1479,4954,2489,84218.0,0.279
30646,2019,18360,5331,8875,7493,1382,5259,2234,92289.2,0.252
30647,2010,1735,931,746,720,26,520,200,132917.0,0.268
30647,2011,1695,871,721,696,25,528,168,136429.0,0.233
30647,2012,1720,957,711,679,32,544,135,160662.0,0.19
30647,2013,1838,1004,707,707,0,554,153,159362.0,0.216
30647,2014,1853,1045,758,758,0,576,182,130385.0,0.24
30647,2015,1908,1106,754,731,23,571,160,153177.0,0.212
30647,2016,2006,1198,842,796,46,573,223,162500.0,0.265
30647,2017,2076,1231,840,785,55,580,205,174526.0,0.244
30647,2018,2141,1313,845,799,46,601,198,184875.0,0.234
30647,2019,1997,1192,803,737,66,550,187,170096.0,0.233
30648,2010,7541,782,2651,2267,384,1966,301,55033.0,0.114
30648,2011,7784,696,2557,2254,303,1958,296,58097.0,0.116
30648,2012,7803,814,2609,2281,328,1913,368,59327.0,0.141
30648,2013,7310,797,2604,2278,326,1977,301,58203.0,0.116
30648,2014,6926,697,2491,2235,256,1817,418,52120.0,0.168
30648,2015,6640,813,2486,2263,223,1754,509,60430.0,0.205
30648,2016,6714,685,2538,2284,254,1742,542,60550.0,0.214
30648,2017,7167,587,2643,2369,274,1917,452,59639.0,0.171
30648,2018,6393,462,2500,2157,343,1744,413,63701.0,0.165
30648,2019,6452,494,2539,2213,326,1847,366,65576.0,0.144
30650,2010,77119,8666,32576,28079,4497,21332,6747,45945.18,0.207
30650,2011,77899,9053,32942,28164,4778,21754,6410,47724.88,0.195
30650,2012,79358,9159,33528,28854,4674,22193,6661,47911.24,0.199
30650,2013,79788,9309,33309,28690,4619,22128,6562,48278.12,0.197
30650,2014,79309,9205,33254,28288,4966,21900,6388,48623.82,0.192
30650,2015,79489,8915,33420,28484,4936,21822,6662,49116.41,0.199
30650,2016,79920,8814,33265,28800,4465,21795,7005,49018.94,0.211
30650,2017,79495,9157,33443,28835,4608,21598,7237,51711.59,0.216
30650,2018,80458,9214,33961,29291,4670,21882,7409,54353.41,0.218
30650,2019,81668,9998,34477,30167,4310,22611,7556,59136.59,0.219
30655,2010,46981,4878,19194,17246,1948,12032,5214,52057.78,0.272
30655,2011,47243,4925,19385,17264,2121,12171,5093,52167.22,0.263
30655,2012,48259,5570,19639,17571,2068,12272,5299,51555.78,0.27
30655,2013,48368,5471,19604,17356,2248,12159,5197,50044.67,0.265
30655,2014,49928,5093,19765,17391,2374,12096,5295,51949.33,0.268
30655,2015,50844,5494,19617,17362,2255,11767,5595,51736.22,0.285
30655,2016,51236,5894,19558,17652,1906,11973,5679,52792.78,0.29
30655,2017,51799,6057,19896,18115,1781,12329,5786,54685.67,0.291
30655,2018,52370,6452,19910,18332,1578,12460,5872,58315.78,0.295
30655,2019,53024,7203,19910,18511,1399,12940,5571,60528.78,0.28
30656,2010,33708,3002,13704,12588,1116,8761,3827,49827.83,0.279
30656,2011,33588,3132,13944,12635,1309,8744,3891,48048.67,0.279
30656,2012,33818,3440,13696,12495,1201,8718,3777,46276.33,0.276
30656,2013,34473,3686,13808,12509,1299,8855,3654,45293.67,0.265
30656,2014,34109,3499,13918,12516,1402,8711,3805,47670.5,0.273
30656,2015,34695,3588,13614,12355,1259,8409,3946,46391.83,0.29
30656,2016,34977,4049,13631,12534,1097,8589,3945,47291.5,0.289
30656,2017,35059,4377,13810,12665,1145,8775,3890,50897.33,0.282
30656,2018,35637,4499,14029,12941,1088,8782,4159,54251.67,0.296
30656,2019,36378,4827,14053,13060,993,9109,3951,58890.33,0.281
30660,2010,39662,4987,15427,13673,1754,10902,2771,50887.57,0.18
30660,2011,41580,5398,15920,14177,1743,11108,3069,51664.14,0.193
30660,2012,42561,5916,16478,14780,1698,11603,3177,52346.0,0.193
30660,2013,42331,6047,16681,14805,1876,11536,3269,51144.29,0.196
30660,2014,41965,6083,16654,14660,1994,11422,3238,50472.57,0.194
30660,2015,42490,6673,16875,14861,2014,11467,3394,52021.57,0.201
30660,2016,43582,7409,17034,15026,2008,11369,3657,53241.43,0.215
30660,2017,44690,7170,17486,15286,2200,11224,4062,54563.14,0.232
30660,2018,44453,7679,17189,15230,1959,11649,3581,57362.43,0.208
30660,2019,47072,8493,17755,16080,1675,11795,4285,59872.71,0.241
30662,2010,15471,4712,6712,5907,805,4655,1252,86717.0,0.187
30662,2011,15509,4469,6431,5672,759,4428,1244,89437.5,0.193
30662,2012,15435,4598,6362,5588,774,4313,1275,95824.75,0.2
30662,2013,15069,4635,6334,5669,665,4458,1211,95775.5,0.191
30662,2014,15115,4687,6256,5651,605,4247,1404,87436.0,0.224
30662,2015,15247,5232,6326,5791,535,4228,1563,97886.5,0.247
30662,2016,15691,5187,6549,5969,580,4158,1811,99558.5,0.277
30662,2017,16528,5469,6725,6099,626,4446,1653,106727.5,0.246
30662,2018,15834,5461,6611,5889,722,4262,1627,114805.5,0.246
30662,2019,15909,5608,6652,5997,655,4423,1574,116845.25,0.237
30663,2010,34798,3547,14975,13040,1935,9605,3435,44930.12,0.229
30663,2011,35312,3593,15064,13057,2007,9920,3137,45644.75,0.208
30663,2012,36309,3697,15445,13500,1945,10204,3296,47343.88,0.213
30663,2013,36630,3991,15598,13468,2130,10348,3120,48737.5,0.2
30663,2014,37167,3885,15754,13443,2311,10424,3019,50468.0,0.192
30663,2015,37386,3787,15763,13458,2305,10263,3195,50485.0,0.203
30663,2016,37826,3906,16003,13808,2195,10574,3234,51337.12,0.202
30663,2017,36854,3661,16205,13780,2425,10377,3403,52471.62,0.21
30663,2018,36964,3777,16101,13801,2300,10401,3400,53734.0,0.211
30663,2019,38077,4594,16420,14223,2197,10910,3313,57955.5,0.202
30664,2010,14520,1257,6257,5322,935,4110,1212,46248.75,0.194
30664,2011,15225,1291,6455,5484,971,4230,1254,46333.25,0.194
30664,2012,15457,1404,6642,5831,811,4497,1334,48513.0,0.201
30664,2013,15802,1643,6615,5786,829,4547,1239,49112.25,0.187
30664,2014,16187,1697,6676,5696,980,4556,1140,49589.75,0.171
30664,2015,16299,1550,6644,5706,938,4565,1141,50407.75,0.172
30664,2016,16274,1659,6649,5802,847,4622,1180,52476.25,0.177
30664,2017,15759,1605,6700,5706,994,4351,1355,54599.75,0.202
30664,2018,15741,1561,6614,5728,886,4394,1334,55762.75,0.202
30664,2019,15689,1777,6729,5883,846,4473,1410,57414.5,0.21
30666,2010,13927,1417,5446,5032,414,4059,973,50032.67,0.179
30666,2011,14333,1528,5730,5249,481,4188,1061,52525.33,0.185
30666,2012,15233,1481,5813,5316,497,4378,938,51327.0,0.161
30666,2013,16042,1735,5998,5494,504,4462,1032,53135.0,0.172
30666,2014,16461,1585,6067,5457,610,4316,1141,56314.33,0.188
30666,2015,16109,1518,6039,5331,708,4089,1242,53653.33,0.206
30666,2016,17097,1738,6337,5715,622,4513,1202,52397.67,0.19
30666,2017,17067,1844,6321,5734,587,4373,1361,57725.67,0.215
30666,2018,17338,1976,6537,6026,511,4629,1397,57837.0,0.214
30666,2019,17770,2260,6409,5960,449,4727,1233,65711.67,0.192
30667,2010,7541,782,2651,2267,384,1966,301,55033.0,0.114
30667,2011,7784,696,2557,2254,303,1958,296,58097.0,0.116
30667,2012,7803,814,2609,2281,328,1913,368,59327.0,0.141
30667,2013,7310,797,2604,2278,326,1977,301,58203.0,0.116
30667,2014,6926,697,2491,2235,256,1817,418,52120.0,0.168
30667,2015,6640,813,2486,2263,223,1754,509,60430.0,0.205
30667,2016,6714,685,2538,2284,254,1742,542,60550.0,0.214
30667,2017,7167,587,2643,2369,274,1917,452,59639.0,0.171
30667,2018,6393,462,2500,2157,343,1744,413,63701.0,0.165
30667,2019,6452,494,2539,2213,326,1847,366,65576.0,0.144
30668,2010,17406,1573,8109,6571,1538,4813,1758,43381.33,0.217
30668,2011,18098,1954,8366,6649,1717,5074,1575,45519.0,0.188
30668,2012,18131,2188,8406,6838,1568,5276,1562,46529.33,0.186
30668,2013,19098,2506,8569,7090,1479,5531,1559,47107.67,0.182
30668,2014,19285,2717,8837,7175,1662,5579,1596,47263.67,0.181
30668,2015,19634,2889,8931,7274,1657,5708,1566,48216.33,0.175
30668,2016,19423,3149,8786,7295,1491,5620,1675,46216.67,0.191
30668,2017,19732,3392,8982,7392,1590,5574,1818,48458.67,0.202
30668,2018,19118,3134,8991,7327,1664,5553,1774,50337.67,0.197
30668,2019,19790,3127,9176,7601,1575,5821,1780,52601.0,0.194
30669,2010,22061,2039,8908,7589,1319,6076,1513,48005.6,0.17
30669,2011,23009,1987,9012,7738,1274,6188,1550,48686.0,0.172
30669,2012,23260,2218,9251,8112,1139,6410,1702,50675.8,0.184
30669,2013,23112,2440,9219,8064,1155,6524,1540,50930.4,0.167
30669,2014,23113,2394,9167,7931,1236,6373,1558,50095.8,0.17
30669,2015,22939,2363,9130,7969,1161,6319,1650,52412.2,0.181
30669,2016,22988,2344,9187,8086,1101,6364,1722,54091.0,0.187
30669,2017,22926,2192,9343,8075,1268,6268,1807,55607.6,0.193
30669,2018,22134,2023,9114,7885,1229,6138,1747,57350.4,0.192
30669,2019,22141,2271,9268,8096,1172,6320,1776,59046.8,0.192
30673,2010,39835,4936,16285,14416,1869,10993,3423,48533.0,0.21
30673,2011,41284,5478,16771,14887,1884,11253,3634,49097.57,0.217
30673,2012,42184,5907,17189,15342,1847,11595,3747,49652.0,0.218
30673,2013,42774,6187,17461,15510,1951,11532,3978,48717.71,0.228
30673,2014,43002,6392,17467,15469,1998,11558,3911,49434.14,0.224
30673,2015,43587,6774,17619,15486,2133,11603,3883,49429.29,0.22
30673,2016,44566,7575,17725,15628,2097,11551,4077,50997.71,0.23
30673,2017,45284,7429,18111,15745,2366,11276,4469,53640.71,0.247
30673,2018,45745,8001,17848,15840,2008,11815,4025,56424.57,0.226
30673,2019,48542,8942,18582,16835,1747,11950,4885,58020.29,0.263
30678,2010,14520,1257,6257,5322,935,4110,1212,46248.75,0.194
30678,2011,15225,1291,6455,5484,971,4230,1254,46333.25,0.194
30678,2012,15457,1404,6642,5831,811,4497,1334,48513.0,0.201
30678,2013,15802,1643,6615,5786,829,4547,1239,49112.25,0.187
30678,2014,16187,1697,6676,5696,980,4556,1140,49589.75,0.171
30678,2015,16299,1550,6644,5706,938,4565,1141,50407.75,0.172
30678,2016,16274,1659,6649,5802,847,4622,1180,52476.25,0.177
30678,2017,15759,1605,6700,5706,994,4351,1355,54599.75,0.202
30678,2018,15741,1561,6614,5728,886,4394,1334,55762.75,0.202
30678,2019,15689,1777,6729,5883,846,4473,1410,57414.5,0.21
30680,2010,75703,8182,28745,25801,2944,20269,5532,51152.12,0.192
30680,2011,78827,9319,29493,26632,2861,20971,5661,51757.76,0.192
30680,2012,80228,9522,29604,26692,2912,21107,5585,52467.35,0.189
30680,2013,81138,10124,29440,26425,3015,21024,5401,53649.94,0.183
30680,2014,83881,10356,29844,26440,3404,20685,5755,53404.76,0.193
30680,2015,84560,9952,29981,26648,3333,20016,6632,52246.94,0.221
30680,2016,86424,10233,30534,27295,3239,20336,6959,55036.0,0.228
30680,2017,89099,11372,31398,28259,3139,21314,6945,58125.06,0.221
30680,2018,92292,12093,32291,29480,2811,21862,7618,60221.18,0.236
30680,2019,94276,13137,33077,30724,2353,23688,7036,65413.94,0.213
30683,2010,2570,1377,1350,1184,166,801,383,78015.0,0.284
30683,2011,2540,1421,1301,1158,143,754,404,81814.0,0.311
30683,2012,2564,1432,1289,1158,131,744,414,82038.0,0.321
30683,2013,2428,1478,1261,1154,107,719,435,83378.0,0.345
30683,2014,2451,1543,1257,1169,88,695,474,83720.0,0.377
30683,2015,2585,1644,1297,1234,63,742,492,78897.0,0.379
30683,2016,2520,1634,1355,1312,43,763,549,77000.0,0.405
30683,2017,2574,1584,1361,1294,67,745,549,78681.0,0.403
30683,2018,2585,1543,1365,1269,96,772,497,82882.0,0.364
30683,2019,2701,1586,1342,1245,97,841,404,106103.0,0.301
30701,2010,58799,4228,26179,21847,4332,15542,6305,39438.82,0.241
30701,2011,59174,4613,26430,21634,4796,15306,6328,40501.55,0.239
30701,2012,59086,5124,26495,21755,4740,15823,5932,40894.09,0.224
30701,2013,59093,5273,26494,21843,4651,15848,5995,40820.73,0.226
30701,2014,59041,5878,26618,21892,4726,15622,6270,39469.55,0.236
30701,2015,59000,6000,26599,21733,4866,15372,6361,40122.36,0.239
30701,2016,59004,6352,26490,21787,4703,15415,6372,40102.36,0.241
30701,2017,59388,6613,26842,21975,4867,15483,6492,41005.27,0.242
30701,2018,59335,6433,26874,22215,4659,15529,6686,42778.55,0.249
30701,2019,59962,6075,27053,22312,4741,15842,6470,45698.27,0.239
30703,2010,3219,248,1517,1188,329,766,422,39630.0,0.278
30703,2011,2972,200,1531,1123,408,754,369,40795.0,0.241
30703,2012,3037,208,1600,1198,402,867,331,39695.0,0.207
30703,2013,3243,292,1602,1259,343,867,392,39362.0,0.245
30703,2014,3332,395,1563,1242,321,825,417,40395.0,0.267
30703,2015,3539,421,1535,1242,293,876,366,39781.0,0.238
30703,2016,3641,505,1501,1289,212,894,395,37989.0,0.263
30703,2017,4050,513,1549,1394,155,894,500,38648.0,0.323
30703,2018,3775,475,1536,1365,171,948,417,37414.0,0.271
30703,2019,3811,439,1507,1359,148,913,446,37976.0,0.296
30705,2010,42393,5305,18428,15723,2705,11734,3989,44228.88,0.216
30705,2011,42512,5384,18412,15522,2890,11904,3618,47452.62,0.197
30705,2012,44027,5383,18822,15920,2902,12068,3852,47460.38,0.205
30705,2013,43831,5235,18512,15604,2908,11766,3838,47984.62,0.207
30705,2014,43107,5220,18439,15273,3166,11561,3712,48767.38,0.201
30705,2015,43398,5148,18619,15471,3148,11453,4018,49754.62,0.216
30705,2016,43538,5187,18397,15590,2807,11303,4287,50054.75,0.233
30705,2017,43474,5524,18456,15615,2841,11377,4238,52268.0,0.23
30705,2018,43577,5486,18834,15870,2964,11437,4433,55011.88,0.235
30705,2019,44661,5778,19182,16573,2609,11926,4647,60471.12,0.242
30707,2010,6219,1563,2901,2616,285,1177,1439,83750.0,0.496
30707,2011,5949,1624,2732,2456,276,1128,1328,86827.5,0.486
30707,2012,5796,1741,2652,2379,273,1216,1163,97754.0,0.439
30707,2013,5378,1690,2567,2235,332,1158,1077,98751.0,0.42
30707,2014,5433,1666,2604,2276,328,1276,1000,82316.0,0.384
30707,2015,5772,1833,2685,2368,317,1299,1069,96269.5,0.398
30707,2016,6375,1948,2931,2626,305,1282,1344,101346.0,0.459
30707,2017,6729,2027,2861,2568,293,1240,1328,108249.0,0.464
30707,2018,6806,2241,2871,2627,244,1310,1317,115111.0,0.459
30707,2019,6577,2197,2896,2622,274,1298,1324,107697.0,0.457
30708,2010,15817,1526,6075,5368,707,4202,1166,46667.0,0.192
30708,2011,15993,1919,6289,5573,716,4363,1210,47577.75,0.192
30708,2012,15723,1794,6323,5565,758,4397,1168,45782.75,0.185
30708,2013,15715,1779,6397,5744,653,4529,1215,45100.5,0.19
30708,2014,15800,1733,6360,5754,606,4524,1230,44910.0,0.193
30708,2015,15567,1662,6328,5708,620,4523,1185,45964.5,0.187
30708,2016,15624,1347,6312,5700,612,4518,1182,43475.0,0.187
30708,2017,15876,1453,6365,5796,569,4512,1284,49000.25,0.202
30708,2018,16585,1538,6529,5914,615,4662,1252,53260.75,0.192
30708,2019,16335,1702,6496,5822,674,4678,1144,58714.75,0.176
30711,2010,15817,1526,6075,5368,707,4202,1166,46667.0,0.192
30711,2011,15993,1919,6289,5573,716,4363,1210,47577.75,0.192
30711,2012,15723,1794,6323,5565,758,4397,1168,45782.75,0.185
30711,2013,15715,1779,6397,5744,653,4529,1215,45100.5,0.19
30711,2014,15800,1733,6360,5754,606,4524,1230,44910.0,0.193
30711,2015,15567,1662,6328,5708,620,4523,1185,45964.5,0.187
30711,2016,15624,1347,6312,5700,612,4518,1182,43475.0,0.187
30711,2017,15876,1453,6365,5796,569,4512,1284,49000.25,0.202
30711,2018,16585,1538,6529,5914,615,4662,1252,53260.75,0.192
30711,2019,16335,1702,6496,5822,674,4678,1144,58714.75,0.176
30720,2010,11195,5185,6691,5363,1328,1578,3785,56614.67,0.566
30720,2011,12338,5600,7099,5708,1391,1865,3843,60682.67,0.541
30720,2012,12619,5215,7174,5784,1390,1850,3934,57439.67,0.548
30720,2013,12149,5074,7130,5754,1376,1776,3978,57770.0,0.558
30720,2014,12765,5489,7194,5928,1266,1833,4095,58729.67,0.569
30720,2015,12509,5248,7206,6004,1202,1632,4372,58265.67,0.607
30720,2016,12761,5608,7262,5968,1294,1750,4218,60716.0,0.581
30720,2017,13268,6332,7349,6120,1229,1955,4165,66922.0,0.567
30720,2018,14809,7094,7644,6650,994,2138,4512,68100.0,0.59
30720,2019,14914,7326,7768,6807,961,2033,4774,68114.33,0.615
30721,2010,40251,13109,22394,18741,3653,11109,7632,58536.56,0.341
30721,2011,39888,13738,22277,18510,3767,11312,7198,60536.0,0.323
30721,2012,40592,13327,22105,18685,3420,11456,7229,61145.78,0.327
30721,2013,40381,13143,21991,18446,3545,11215,7231,62019.78,0.329
30721,2014,41354,13886,22105,18766,3339,11458,7308,62743.56,0.331
30721,2015,41957,14247,22293,19132,3161,11076,8056,65154.22,0.361
30721,2016,42229,14274,22471,19099,3372,11133,7966,66141.0,0.355
30721,2017,43499,14796,22629,19060,3569,11364,7696,70026.11,0.34
30721,2018,43528,15468,22781,19199,3582,11640,7559,74470.22,0.332
30721,2019,44718,16246,23302,19616,3686,11822,7794,80785.56,0.334
30725,2010,2570,1377,1350,1184,166,801,383,78015.0,0.284
30725,2011,2540,1421,1301,1158,143,754,404,81814.0,0.311
30725,2012,2564,1432,1289,1158,131,744,414,82038.0,0.321
30725,2013,2428,1478,1261,1154,107,719,435,83378.0,0.345
30725,2014,2451,1543,1257,1169,88,695,474,83720.0,0.377
30725,2015,2585,1644,1297,1234,63,742,492,78897.0,0.379
30725,2016,2520,1634,1355,1312,43,763,549,77000.0,0.405
30725,2017,2574,1584,1361,1294,67,745,549,78681.0,0.403
30725,2018,2585,1543,1365,1269,96,772,497,82882.0,0.364
30725,2019,2701,1586,1342,1245,97,841,404,106103.0,0.301
30728,2010,2033,543,1178,941,237,594,347,40518.0,0.295
30728,2011,1954,641,1161,918,243,533,385,33750.0,0.332
30728,2012,1991,702,1170,935,235,546,389,39583.0,0.332
30728,2013,2010,781,1185,907,278,548,359,46458.0,0.303
30728,2014,2060,759,1153,893,260,497,396,45742.0,0.343
30728,2015,2245,895,1158,918,240,492,426,50833.0,0.368
30728,2016,2256,918,1197,979,218,549,430,51339.0,0.359
30728,2017,2231,908,1181,962,219,525,437,53833.0,0.37
30728,2018,2351,1069,1198,1045,153,638,407,59375.0,0.34
30728,2019,2634,1202,1231,1058,173,717,341,95417.0,0.277
30730,2010,27817,3338,10629,9473,1156,7162,2311,45487.0,0.217
30730,2011,27694,3867,10943,9639,1304,7415,2224,48873.83,0.203
30730,2012,27596,3634,10918,9672,1246,7404,2268,47342.5,0.208
30730,2013,27180,3478,10807,9681,1126,7388,2293,47329.5,0.212
30730,2014,27265,3410,10811,9634,1177,7445,2189,46298.83,0.202
30730,2015,26508,3276,10851,9565,1286,7466,2099,48155.0,0.193
30730,2016,26670,2842,10772,9615,1157,7380,2235,45520.5,0.207
30730,2017,27226,3124,10991,9760,1231,7519,2241,50112.0,0.204
30730,2018,28028,3052,11184,9907,1277,7657,2250,54526.0,0.201
30730,2019,27545,3167,11025,9757,1268,7568,2189,60891.0,0.199
30731,2010,32754,4261,14011,12030,1981,9116,2914,46887.33,0.208
30731,2011,32864,4174,14060,11880,2180,9130,2750,49811.67,0.196
30731,2012,34031,4319,14375,12230,2145,9240,2990,49471.5,0.208
30731,2013,33856,4150,14054,11886,2168,8926,2960,49495.5,0.211
30731,2014,33270,4099,13899,11509,2390,8724,2785,48711.17,0.2
30731,2015,33482,4103,14060,11698,2362,8737,2961,49221.17,0.211
30731,2016,33471,4235,13740,11748,1992,8516,3232,50176.33,0.235
30731,2017,33423,4547,13711,11740,1971,8526,3214,52792.67,0.234
30731,2018,33648,4546,14023,12007,2016,8579,3428,56170.33,0.244
30731,2019,34160,4575,14290,12575,1715,8875,3700,60702.67,0.259
30732,2010,17406,1573,8109,6571,1538,4813,1758,43381.33,0.217
30732,2011,18098,1954,8366,6649,1717,5074,1575,45519.0,0.188
30732,2012,18131,2188,8406,6838,1568,5276,1562,46529.33,0.186
30732,2013,19098,2506,8569,7090,1479,5531,1559,47107.67,0.182
30732,2014,19285,2717,8837,7175,1662,5579,1596,47263.67,0.181
30732,2015,19634,2889,8931,7274,1657,5708,1566,48216.33,0.175
30732,2016,19423,3149,8786,7295,1491,5620,1675,46216.67,0.191
30732,2017,19732,3392,8982,7392,1590,5574,1818,48458.67,0.202
30732,2018,19118,3134,8991,7327,1664,5553,1774,50337.67,0.197
30732,2019,19790,3127,9176,7601,1575,5821,1780,52601.0,0.194
30733,2010,12840,2873,5417,4835,582,4005,830,80363.0,0.153
30733,2011,12775,2901,5359,4656,703,3738,918,85396.0,0.171
30733,2012,12409,2747,5401,4602,799,3714,888,83118.5,0.164
30733,2013,12129,2687,5451,4742,709,3830,912,84757.0,0.167
30733,2014,12037,2818,5351,4498,853,3563,935,82722.0,0.175
30733,2015,11914,3036,5356,4565,791,3526,1039,88026.0,0.194
30733,2016,11797,2999,5264,4489,775,3443,1046,87026.5,0.199
30733,2017,12094,3350,5353,4668,685,3653,1015,93996.0,0.19
30733,2018,12667,3548,5333,4733,600,3588,1145,96181.5,0.215
30733,2019,13131,3740,5508,4952,556,3712,1240,105448.0,0.225
30734,2010,20904,1737,9455,7845,1610,5910,1935,42886.25,0.205
30734,2011,21917,2170,9740,7964,1776,6182,1782,44836.75,0.183
30734,2012,21872,2450,9789,8138,1651,6307,1831,45701.5,0.187
30734,2013,22987,2779,9938,8391,1547,6524,1867,46211.75,0.188
30734,2014,23113,3053,10216,8465,1751,6598,1867,46122.75,0.183
30734,2015,23591,3256,10411,8640,1771,6768,1872,46500.0,0.18
30734,2016,23095,3488,10235,8623,1612,6642,1981,45976.75,0.194
30734,2017,23419,3782,10389,8682,1707,6595,2087,49558.25,0.201
30734,2018,23011,3537,10446,8665,1781,6572,2093,53341.5,0.2
30734,2019,23818,3548,10667,8963,1704,6796,2167,55616.25,0.203
30735,2010,32780,4722,15911,12966,2945,8456,4510,43677.33,0.283
30735,2011,33342,5302,16126,12968,3158,8792,4176,46585.17,0.259
30735,2012,33677,5388,16151,13293,2858,9202,4091,46906.5,0.253
30735,2013,33923,5522,16153,13289,2864,9309,3980,47242.0,0.246
30735,2014,34770,6215,16305,13494,2811,9411,4083,47618.67,0.25
30735,2015,35031,6372,16397,13664,2733,9247,4417,47500.33,0.269
30735,2016,35026,6549,16359,13661,2698,9271,4390,48042.0,0.268
30735,2017,36082,7038,16472,13682,2790,9256,4426,50140.67,0.269
30735,2018,35606,7046,16339,13740,2599,9413,4327,52986.17,0.265
30735,2019,36171,6851,16464,13873,2591,9584,4289,54073.0,0.261
30736,2010,9087,896,2574,2197,377,857,1340,35907.5,0.521
30736,2011,7742,1267,2425,2095,330,824,1271,49419.0,0.524
30736,2012,7350,1126,2348,2048,300,902,1146,48744.5,0.488
30736,2013,6539,1001,2266,1877,389,797,1080,50867.0,0.477
30736,2014,6497,914,2236,1859,377,901,958,51439.0,0.428
30736,2015,6798,1112,2328,1973,355,937,1036,55514.5,0.445
30736,2016,7338,1138,2503,2180,323,941,1239,54957.0,0.495
30736,2017,7774,1255,2439,2131,308,862,1269,56593.0,0.52
30736,2018,8079,1476,2450,2184,266,930,1254,60119.0,0.512
30736,2019,7919,1535,2510,2232,278,991,1241,64702.5,0.494
30738,2010,2570,1377,1350,1184,166,801,383,78015.0,0.284
30738,2011,2540,1421,1301,1158,143,754,404,81814.0,0.311
30738,2012,2564,1432,1289,1158,131,744,414,82038.0,0.321
30738,2013,2428,1478,1261,1154,107,719,435,83378.0,0.345
30738,2014,2451,1543,1257,1169,88,695,474,83720.0,0.377
30738,2015,2585,1644,1297,1234,63,742,492,78897.0,0.379
30738,2016,2520,1634,1355,1312,43,763,549,77000.0,0.405
30738,2017,2574,1584,1361,1294,67,745,549,78681.0,0.403
30738,2018,2585,1543,1365,1269,96,772,497,82882.0,0.364
30738,2019,2701,1586,1342,1245,97,841,404,106103.0,0.301
30740,2010,8928,1647,2272,1736,536,466,1270,42178.5,0.559
30740,2011,9117,2159,2819,2214,605,645,1569,54434.5,0.557
30740,2012,9595,1930,3037,2397,640,652,1745,52489.0,0.575
30740,2013,9101,1986,3117,2458,659,592,1866,53582.0,0.599
30740,2014,9333,2068,3226,2520,706,602,1918,56621.5,0.595
30740,2015,8840,1860,3232,2468,764,516,1952,57406.5,0.604
30740,2016,9203,2281,3230,2456,774,558,1898,57138.0,0.588
30740,2017,9471,2871,3464,2731,733,678,2053,61091.5,0.593
30740,2018,11060,3243,3709,3082,627,748,2334,64309.5,0.629
30740,2019,11291,3454,3888,3341,547,832,2509,68896.5,0.645
30741,2010,8242,2672,4152,3739,413,1765,1974,78112.67,0.475
30741,2011,8048,2819,3939,3548,391,1690,1858,80511.33,0.472
30741,2012,7861,2938,3858,3447,411,1747,1700,89873.67,0.441
30741,2013,7459,2877,3715,3230,485,1692,1538,92263.67,0.414
30741,2014,7473,2890,3759,3256,503,1795,1461,84044.0,0.389
30741,2015,7861,3071,3869,3393,476,1870,1523,98456.0,0.394
30741,2016,8514,3207,4121,3620,501,1859,1761,99500.33,0.427
30741,2017,8774,3298,4014,3552,462,1822,1730,101462.33,0.431
30741,2018,8705,3453,4016,3597,419,1848,1749,105022.0,0.436
30741,2019,8458,3488,4031,3605,426,1869,1736,100087.0,0.431
30742,2010,6219,1563,2901,2616,285,1177,1439,83750.0,0.496
30742,2011,5949,1624,2732,2456,276,1128,1328,86827.5,0.486
30742,2012,5796,1741,2652,2379,273,1216,1163,97754.0,0.439
30742,2013,5378,1690,2567,2235,332,1158,1077,98751.0,0.42
30742,2014,5433,1666,2604,2276,328,1276,1000,82316.0,0.384
30742,2015,5772,1833,2685,2368,317,1299,1069,96269.5,0.398
30742,2016,6375,1948,2931,2626,305,1282,1344,101346.0,0.459
30742,2017,6729,2027,2861,2568,293,1240,1328,108249.0,0.464
30742,2018,6806,2241,2871,2627,244,1310,1317,115111.0,0.459
30742,2019,6577,2197,2896,2622,274,1298,1324,107697.0,0.457
30746,2010,10945,803,4723,3964,759,2871,1093,39337.0,0.231
30746,2011,10979,878,4730,3984,746,2825,1159,39211.5,0.245
30746,2012,11425,899,4792,4117,675,3039,1078,40018.0,0.225
30746,2013,10858,829,4687,3910,777,2942,968,40703.5,0.207
30746,2014,11293,1105,4605,3923,682,2959,964,41279.5,0.209
30746,2015,11031,1133,4580,3879,701,2749,1130,40085.5,0.247
30746,2016,11295,1125,4641,3879,762,2827,1052,44623.0,0.227
30746,2017,11713,1187,4645,3853,792,2792,1061,46002.0,0.228
30746,2018,11839,1217,4555,3908,647,2831,1077,48250.0,0.236
30746,2019,11764,1091,4516,3867,649,2884,983,50072.5,0.218
30747,2010,78886,10012,32749,28286,4463,21699,6587,47478.76,0.201
30747,2011,79808,10230,33157,28442,4715,22078,6364,48841.41,0.192
30747,2012,81087,10066,33803,29188,4615,22598,6590,48884.29,0.195
30747,2013,81448,10181,33549,29066,4483,22568,6498,49064.29,0.194
30747,2014,80975,10196,33468,28636,4832,22326,6310,49718.47,0.189
30747,2015,81324,9934,33615,28823,4792,22209,6614,50859.59,0.197
30747,2016,81562,9911,33410,29144,4266,22201,6943,51429.59,0.208
30747,2017,81537,10369,33559,29155,4404,22000,7155,54236.94,0.213
30747,2018,82224,10200,33978,29479,4499,22172,7307,57002.59,0.215
30747,2019,83014,10925,34401,30238,4163,22777,7461,61374.0,0.217
30750,2010,2570,1377,1350,1184,166,801,383,78015.0,0.284
30750,2011,2540,1421,1301,1158,143,754,404,81814.0,0.311
30750,2012,2564,1432,1289,1158,131,744,414,82038.0,0.321
30750,2013,2428,1478,1261,1154,107,719,435,83378.0,0.345
30750,2014,2451,1543,1257,1169,88,695,474,83720.0,0.377
30750,2015,2585,1644,1297,1234,63,742,492,78897.0,0.379
30750,2016,2520,1634,1355,1312,43,763,549,77000.0,0.405
30750,2017,2574,1584,1361,1294,67,745,549,78681.0,0.403
30750,2018,2585,1543,1365,1269,96,772,497,82882.0,0.364
30750,2019,2701,1586,1342,1245,97,841,404,106103.0,0.301
30751,2010,15817,1526,6075,5368,707,4202,1166,46667.0,0.192
30751,2011,15993,1919,6289,5573,716,4363,1210,47577.75,0.192
30751,2012,15723,1794,6323,5565,758,4397,1168,45782.75,0.185
30751,2013,15715,1779,6397,5744,653,4529,1215,45100.5,0.19
30751,2014,15800,1733,6360,5754,606,4524,1230,44910.0,0.193
30751,2015,15567,1662,6328,5708,620,4523,1185,45964.5,0.187
30751,2016,15624,1347,6312,5700,612,4518,1182,43475.0,0.187
30751,2017,15876,1453,6365,5796,569,4512,1284,49000.25,0.202
30751,2018,16585,1538,6529,5914,615,4662,1252,53260.75,0.192
30751,2019,16335,1702,6496,5822,674,4678,1144,58714.75,0.176
30753,2010,36159,4113,15228,13120,2108,9688,3432,42969.5,0.225
30753,2011,36574,4449,15461,13192,2269,10056,3136,46127.0,0.203
30753,2012,37326,4308,15684,13628,2056,10332,3296,47228.75,0.21
30753,2013,37242,4427,15483,13441,2042,10246,3195,48366.0,0.206
30753,2014,37489,4495,15667,13340,2327,10314,3026,49298.0,0.193
30753,2015,37156,4209,15726,13336,2390,10224,3112,51176.62,0.198
30753,2016,37387,4106,15766,13559,2207,10271,3288,51063.5,0.209
30753,2017,37160,4253,16071,13545,2526,10209,3336,53057.25,0.208
30753,2018,37113,4015,16080,13584,2496,10247,3337,55029.62,0.208
30753,2019,37400,4445,16150,13816,2334,10414,3402,59962.25,0.211
30755,2010,8928,1647,2272,1736,536,466,1270,42178.5,0.559
30755,2011,9117,2159,2819,2214,605,645,1569,54434.5,0.557
30755,2012,9595,1930,3037,2397,640,652,1745,52489.0,0.575
30755,2013,9101,1986,3117,2458,659,592,1866,53582.0,0.599
30755,2014,9333,2068,3226,2520,706,602,1918,56621.5,0.595
30755,2015,8840,1860,3232,2468,764,516,1952,57406.5,0.604
30755,2016,9203,2281,3230,2456,774,558,1898,57138.0,0.588
30755,2017,9471,2871,3464,2731,733,678,2053,61091.5,0.593
30755,2018,11060,3243,3709,3082,627,748,2334,64309.5,0.629
30755,2019,11291,3454,3888,3341,547,832,2509,68896.5,0.645
30802,2010,5765,2054,2610,2449,161,2040,409,72720.0,0.157
30802,2011,6043,2094,2617,2425,192,2050,375,76141.0,0.143
30802,2012,6331,2065,2607,2434,173,1955,479,68917.0,0.184
30802,2013,6560,2068,2602,2400,202,1898,502,59844.0,0.193
30802,2014,6803,1908,2547,2387,160,1839,548,57202.0,0.215
30802,2015,6821,1699,2542,2330,212,1783,547,56979.0,0.215
30802,2016,6678,1742,2581,2365,216,1686,679,57797.0,0.263
30802,2017,6569,1964,2556,2281,275,1798,483,72306.0,0.189
30802,2018,6159,2020,2578,2265,313,1638,627,81744.0,0.243
30802,2019,5956,2118,2624,2390,234,1674,716,83611.0,0.273
30803,2010,34269,3107,12922,11313,1609,9037,2276,47369.17,0.176
30803,2011,34626,3490,12999,11528,1471,9064,2464,48450.5,0.19
30803,2012,35483,3526,13423,11867,1556,9213,2654,47924.33,0.198
30803,2013,35180,3509,13430,12026,1404,9384,2642,47251.67,0.197
30803,2014,34517,3279,13147,11869,1278,8999,2870,46278.83,0.218
30803,2015,33958,3185,13130,11871,1259,8770,3101,48161.67,0.236
30803,2016,33680,2752,13249,12017,1232,8571,3446,46271.83,0.26
30803,2017,33694,2798,13299,12138,1161,8886,3252,49759.83,0.245
30803,2018,34366,2971,13586,12227,1359,9025,3202,53923.83,0.236
30803,2019,33886,3128,13435,12066,1369,9152,2914,58327.67,0.217
30805,2010,6240,667,2631,2202,429,841,1361,34167.0,0.517
30805,2011,6342,674,2970,2397,573,918,1479,29840.0,0.498
30805,2012,6437,696,3008,2412,596,1029,1383,33348.0,0.46
30805,2013,6535,807,3107,2394,713,906,1488,36435.0,0.479
30805,2014,6611,842,3108,2447,661,869,1578,37118.0,0.508
30805,2015,6649,892,3296,2587,709,939,1648,41670.0,0.5
30805,2016,6658,1101,3503,2729,774,942,1787,43326.0,0.51
30805,2017,6622,950,3245,2487,758,838,1649,44828.0,0.508
30805,2018,6581,1147,3303,2664,639,1095,1569,46875.0,0.475
30805,2019,6577,1152,3380,2780,600,985,1795,44881.0,0.531
30807,2010,5616,530,2802,2396,406,1539,857,31538.0,0.306
30807,2011,5424,516,2790,2311,479,1375,936,31613.0,0.335
30807,2012,5351,512,2630,2100,530,1300,800,32386.0,0.304
30807,2013,5466,363,2533,2036,497,1167,869,33508.0,0.343
30807,2014,5531,312,2569,2087,482,1164,923,32943.0,0.359
30807,2015,5538,291,2642,2053,589,1098,955,30763.0,0.361
30807,2016,5447,301,2724,2089,635,1149,940,32802.0,0.345
30807,2017,5206,342,2749,2052,697,1207,845,32969.0,0.307
30807,2018,5087,343,2796,2155,641,1204,951,32722.0,0.34
30807,2019,5053,240,2663,2031,632,1293,738,36139.0,0.277
30809,2010,8165,1976,3351,2795,556,2583,212,76490.0,0.063
30809,2011,7856,2038,3590,2852,738,2600,252,73098.0,0.07
30809,2012,8105,2158,3615,2981,634,2713,268,74220.0,0.074
30809,2013,8690,2244,3485,3017,468,2442,575,71569.0,0.165
30809,2014,9373,2449,3646,3291,355,2642,649,69647.0,0.178
30809,2015,9119,2554,3608,3186,422,2509,677,73302.0,0.188
30809,2016,9250,2741,3528,3251,277,2510,741,74049.0,0.21
30809,2017,9627,2848,3548,3269,279,2473,796,76602.0,0.224
30809,2018,9370,2770,3563,3305,258,2658,647,78494.0,0.182
30809,2019,9369,2676,3501,3205,296,2594,611,89863.0,0.175
30810,2010,39885,3637,15724,13709,2015,10576,3133,45107.57,0.199
30810,2011,40050,4006,15789,13839,1950,10439,3400,46045.14,0.215
30810,2012,40834,4038,16053,13967,2086,10513,3454,45704.57,0.215
30810,2013,40646,3872,15963,14062,1901,10551,3511,45288.29,0.22
30810,2014,40048,3591,15716,13956,1760,10163,3793,44373.71,0.241
30810,2015,39496,3476,15772,13924,1848,9868,4056,45676.14,0.257
30810,2016,39127,3053,15973,14106,1867,9720,4386,44347.57,0.275
30810,2017,38900,3140,16048,14190,1858,10093,4097,47361.14,0.255
30810,2018,39453,3314,16382,14382,2000,10229,4153,50895.0,0.254
30810,2019,38939,3368,16098,14097,2001,10445,3652,55157.86,0.227
30813,2010,14993,4758,6754,6095,659,3355,2740,73066.67,0.406
30813,2011,15596,4792,6861,6282,579,3286,2996,74625.67,0.437
30813,2012,16316,4798,6965,6414,551,3382,3032,76039.0,0.435
30813,2013,15883,5028,7006,6535,471,3496,3039,76421.67,0.434
30813,2014,15391,4937,6967,6488,479,3270,3218,77843.0,0.462
30813,2015,16144,5022,6997,6620,377,3272,3348,81222.67,0.478
30813,2016,16203,5275,7107,6704,403,3444,3260,84414.67,0.459
30813,2017,16690,5505,7045,6671,374,3317,3354,91749.33,0.476
30813,2018,17291,5667,7099,6716,383,3329,3387,96947.33,0.477
30813,2019,17122,5818,7227,6763,464,3260,3503,96292.67,0.485
30814,2010,5765,2054,2610,2449,161,2040,409,72720.0,0.157
30814,2011,6043,2094,2617,2425,192,2050,375,76141.0,0.143
30814,2012,6331,2065,2607,2434,173,1955,479,68917.0,0.184
30814,2013,6560,2068,2602,2400,202,1898,502,59844.0,0.193
30814,2014,6803,1908,2547,2387,160,1839,548,57202.0,0.215
30814,2015,6821,1699,2542,2330,212,1783,547,56979.0,0.215
30814,2016,6678,1742,2581,2365,216,1686,679,57797.0,0.263
30814,2017,6569,1964,2556,2281,275,1798,483,72306.0,0.189
30814,2018,6159,2020,2578,2265,313,1638,627,81744.0,0.243
30814,2019,5956,2118,2624,2390,234,1674,716,83611.0,0.273
30815,2010,6240,667,2631,2202,429,841,1361,34167.0,0.517
30815,2011,6342,674,2970,2397,573,918,1479,29840.0,0.498
30815,2012,6437,696,3008,2412,596,1029,1383,33348.0,0.46
30815,2013,6535,807,3107,2394,713,906,1488,36435.0,0.479
30815,2014,6611,842,3108,2447,661,869,1578,37118.0,0.508
30815,2015,6649,892,3296,2587,709,939,1648,41670.0,0.5
30815,2016,6658,1101,3503,2729,774,942,1787,43326.0,0.51
30815,2017,6622,950,3245,2487,758,838,1649,44828.0,0.508
30815,2018,6581,1147,3303,2664,639,1095,1569,46875.0,0.475
30815,2019,6577,1152,3380,2780,600,985,1795,44881.0,0.531
30817,2010,53666,6055,22860,19629,3231,14567,5062,45444.25,0.221
30817,2011,55136,7019,23412,20036,3376,14922,5114,46666.25,0.218
30817,2012,56283,7590,23745,20466,3279,15413,5053,46642.0,0.213
30817,2013,56928,7879,24102,20724,3378,15458,5266,45913.12,0.218
30817,2014,57393,8517,24233,20871,3362,15540,5331,46503.75,0.22
30817,2015,57953,9246,24486,20933,3553,15495,5438,46149.25,0.222
30817,2016,59010,10190,24503,21000,3503,15376,5624,46871.88,0.23
30817,2017,60970,10403,25038,21284,3754,15291,5993,49308.25,0.239
30817,2018,60961,10791,24780,21347,3433,15805,5542,52429.25,0.224
30817,2019,64407,11383,25545,22420,3125,16182,6238,54304.0,0.244
30819,2010,5616,530,2802,2396,406,1539,857,31538.0,0.306
30819,2011,5424,516,2790,2311,479,1375,936,31613.0,0.335
30819,2012,5351,512,2630,2100,530,1300,800,32386.0,0.304
30819,2013,5466,363,2533,2036,497,1167,869,33508.0,0.343
30819,2014,5531,312,2569,2087,482,1164,923,32943.0,0.359
30819,2015,5538,291,2642,2053,589,1098,955,30763.0,0.361
30819,2016,5447,301,2724,2089,635,1149,940,32802.0,0.345
30819,2017,5206,342,2749,2052,697,1207,845,32969.0,0.307
30819,2018,5087,343,2796,2155,641,1204,951,32722.0,0.34
30819,2019,5053,240,2663,2031,632,1293,738,36139.0,0.277
30820,2010,21433,2056,8877,7764,1113,5741,2023,43641.2,0.228
30820,2011,21417,2435,9079,7884,1195,5738,2146,44384.8,0.236
30820,2012,21074,2306,8953,7665,1288,5697,1968,43103.4,0.22
30820,2013,21181,2142,8930,7780,1150,5696,2084,42782.0,0.233
30820,2014,21331,2045,8929,7841,1088,5688,2153,42516.6,0.241
30820,2015,21105,1953,8970,7761,1209,5621,2140,42924.2,0.239
30820,2016,21071,1648,9036,7789,1247,5667,2122,41340.4,0.235
30820,2017,21082,1795,9114,7848,1266,5719,2129,45794.0,0.234
30820,2018,21672,1881,9325,8069,1256,5866,2203,49153.0,0.236
30820,2019,21388,1942,9159,7853,1306,5971,1882,54199.6,0.205
30821,2010,5616,530,2802,2396,406,1539,857,31538.0,0.306
30821,2011,5424,516,2790,2311,479,1375,936,31613.0,0.335
30821,2012,5351,512,2630,2100,530,1300,800,32386.0,0.304
30821,2013,5466,363,2533,2036,497,1167,869,33508.0,0.343
30821,2014,5531,312,2569,2087,482,1164,923,32943.0,0.359
30821,2015,5538,291,2642,2053,589,1098,955,30763.0,0.361
30821,2016,5447,301,2724,2089,635,1149,940,32802.0,0.345
30821,2017,5206,342,2749,2052,697,1207,845,32969.0,0.307
30821,2018,5087,343,2796,2155,641,1204,951,32722.0,0.34
30821,2019,5053,240,2663,2031,632,1293,738,36139.0,0.277
30823,2010,34269,3107,12922,11313,1609,9037,2276,47369.17,0.176
30823,2011,34626,3490,12999,11528,1471,9064,2464,48450.5,0.19
30823,2012,35483,3526,13423,11867,1556,9213,2654,47924.33,0.198
30823,2013,35180,3509,13430,12026,1404,9384,2642,47251.67,0.197
30823,2014,34517,3279,13147,11869,1278,8999,2870,46278.83,0.218
30823,2015,33958,3185,13130,11871,1259,8770,3101,48161.67,0.236
30823,2016,33680,2752,13249,12017,1232,8571,3446,46271.83,0.26
30823,2017,33694,2798,13299,12138,1161,8886,3252,49759.83,0.245
30823,2018,34366,2971,13586,12227,1359,9025,3202,53923.83,0.236
30823,2019,33886,3128,13435,12066,1369,9152,2914,58327.67,0.217
30824,2010,11381,2584,5412,4845,567,3579,1266,52129.0,0.234
30824,2011,11467,2610,5407,4736,671,3425,1311,53877.0,0.242
30824,2012,11682,2577,5237,4534,703,3255,1279,50651.5,0.244
30824,2013,12026,2431,5135,4436,699,3065,1371,46676.0,0.267
30824,2014,12334,2220,5116,4474,642,3003,1471,45072.5,0.288
30824,2015,12359,1990,5184,4383,801,2881,1502,43871.0,0.29
30824,2016,12125,2043,5305,4454,851,2835,1619,45299.5,0.305
30824,2017,11775,2306,5305,4333,972,3005,1328,52637.5,0.25
30824,2018,11246,2363,5374,4420,954,2842,1578,57233.0,0.294
30824,2019,11009,2358,5287,4421,866,2967,1454,59875.0,0.275
30828,2010,21433,2056,8877,7764,1113,5741,2023,43641.2,0.228
30828,2011,21417,2435,9079,7884,1195,5738,2146,44384.8,0.236
30828,2012,21074,2306,8953,7665,1288,5697,1968,43103.4,0.22
30828,2013,21181,2142,8930,7780,1150,5696,2084,42782.0,0.233
30828,2014,21331,2045,8929,7841,1088,5688,2153,42516.6,0.241
30828,2015,21105,1953,8970,7761,1209,5621,2140,42924.2,0.239
30828,2016,21071,1648,9036,7789,1247,5667,2122,41340.4,0.235
30828,2017,21082,1795,9114,7848,1266,5719,2129,45794.0,0.234
30828,2018,21672,1881,9325,8069,1256,5866,2203,49153.0,0.236
30828,2019,21388,1942,9159,7853,1306,5971,1882,54199.6,0.205
30833,2010,18452,1581,6847,5945,902,4835,1110,48773.5,0.162
30833,2011,18633,1571,6710,5955,755,4701,1254,50196.0,0.187
30833,2012,19760,1732,7100,6302,798,4816,1486,52207.5,0.209
30833,2013,19465,1730,7033,6282,751,4855,1427,51554.0,0.203
30833,2014,18717,1546,6787,6115,672,4475,1640,49016.5,0.242
30833,2015,18391,1523,6802,6163,639,4247,1916,52556.0,0.282
30833,2016,18056,1405,6937,6317,620,4053,2264,51865.5,0.326
30833,2017,17818,1345,6934,6342,592,4374,1968,51279.0,0.284
30833,2018,17781,1433,7057,6313,744,4363,1950,55250.0,0.276
30833,2019,17551,1426,6939,6244,695,4474,1770,57553.5,0.255
30901,2010,57156,12107,25468,21306,4162,12469,8837,48770.67,0.347
30901,2011,56666,12620,25846,21393,4453,12710,8683,52867.17,0.336
30901,2012,57274,12063,26041,21685,4356,12717,8968,51205.67,0.344
30901,2013,56529,11605,25560,21233,4327,12151,9082,51050.67,0.355
30901,2014,56627,12148,25384,20990,4394,11915,9075,51570.08,0.358
30901,2015,56551,12035,25575,21285,4290,11791,9494,51913.25,0.371
30901,2016,56433,12440,25293,21214,4079,11613,9601,52962.25,0.38
30901,2017,57842,13820,25327,21445,3882,11857,9588,56858.58,0.379
30901,2018,59275,14759,25782,22131,3651,12124,10007,59994.67,0.388
30901,2019,59870,15118,26189,22897,3292,12332,10565,62700.0,0.403
30903,2010,4603,264,419,301,118,200,101,37232.0,0.241
30903,2011,3488,514,414,335,79,224,111,61612.0,0.268
30903,2012,3274,342,407,348,59,230,118,62643.0,0.29
30903,2013,2999,315,406,349,57,193,156,63594.0,0.384
30903,2014,2917,293,390,341,49,201,140,68631.0,0.359
30903,2015,2934,385,397,336,61,209,127,71667.0,0.32
30903,2016,2969,388,414,350,64,232,118,69722.0,0.285
30903,2017,3121,459,418,348,70,202,146,71214.0,0.349
30903,2018,3414,548,424,356,68,221,135,74891.0,0.318
30903,2019,3339,530,417,347,70,243,104,84107.0,0.249
30904,2010,61933,17391,30686,26421,4265,17481,8940,60491.08,0.291
30904,2011,61355,17378,30527,25866,4661,17186,8680,61859.42,0.284
30904,2012,62681,17158,30636,26158,4478,17209,8949,62139.0,0.292
30904,2013,63467,16943,30219,25840,4379,16750,9090,62578.83,0.301
30904,2014,64204,17460,30251,25636,4615,16756,8880,62563.75,0.294
30904,2015,65650,18316,30702,26244,4458,16968,9276,64877.17,0.302
30904,2016,65143,18490,30419,26089,4330,16419,9670,66111.17,0.318
30904,2017,66471,19468,30457,26244,4213,16668,9576,71757.08,0.314
30904,2018,66163,19731,30966,26300,4666,16560,9740,76728.83,0.315
30904,2019,67225,20698,31739,27360,4379,16948,10412,83514.58,0.328
30905,2010,10372,796,4317,3459,858,1259,2200,32311.5,0.51
30905,2011,10083,798,4572,3555,1017,1249,2306,27781.0,0.504
30905,2012,9774,832,4557,3524,1033,1340,2184,28485.5,0.479
30905,2013,9706,902,4593,3405,1188,1219,2186,29423.0,0.476
30905,2014,9794,967,4537,3430,1107,1127,2303,30623.5,0.508
30905,2015,9746,1022,4708,3615,1093,1219,2396,32356.5,0.509
30905,2016,9650,1242,4923,3704,1219,1231,2473,33094.5,0.502
30905,2017,9997,1167,4598,3489,1109,1168,2321,36086.0,0.505
30905,2018,9629,1382,4536,3655,881,1409,2246,37138.0,0.495
30905,2019,9613,1419,4607,3749,858,1331,2418,34213.5,0.525
30906,2010,84064,11862,36819,31172,5647,20416,10756,45645.83,0.292
30906,2011,85228,11808,36921,31141,5780,20251,10890,45702.92,0.295
30906,2012,88813,12768,37815,31854,5961,20922,10932,45023.75,0.289
30906,2013,89418,12202,37861,31831,6030,20740,11091,44927.58,0.293
30906,2014,89681,12413,37084,31005,6079,19865,11140,44148.67,0.3
30906,2015,89744,12916,37480,31154,6326,19447,11707,44861.5,0.312
30906,2016,88566,12903,37215,31082,6133,18839,12243,45564.75,0.329
30906,2017,87336,12488,37364,31540,5824,18414,13126,47839.58,0.351
30906,2018,89089,13006,37492,32009,5483,18443,13566,50812.0,0.362
30906,2019,89580,13039,37788,32603,5185,18813,13790,55083.75,0.365
30907,2010,11051,3614,4633,4312,321,3277,1035,91396.0,0.223
30907,2011,11936,3582,4866,4516,350,3327,1189,91422.0,0.244
30907,2012,11999,3790,4972,4503,469,3392,1111,91877.5,0.223
30907,2013,11951,3899,4921,4467,454,3306,1161,94018.0,0.236
30907,2014,12413,3779,5119,4644,475,3289,1355,93401.5,0.265
30907,2015,12736,3875,5144,4751,393,3400,1351,96492.0,0.263
30907,2016,12437,4220,5020,4567,453,3299,1268,98421.5,0.253
30907,2017,12477,4238,4926,4596,330,3318,1278,107433.5,0.259
30907,2018,12417,4421,4995,4551,444,3314,1237,110915.0,0.248
30907,2019,12462,4499,4915,4500,415,3241,1259,118100.5,0.256
30909,2010,41628,13845,21018,18105,2913,10292,7813,78341.0,0.372
30909,2011,42326,14038,21295,18302,2993,10026,8276,76153.11,0.389
30909,2012,43486,14011,21439,18525,2914,10273,8252,81138.78,0.385
30909,2013,43543,14161,21526,18573,2953,10133,8440,79949.0,0.392
30909,2014,44328,14452,21673,18764,2909,10026,8738,80145.89,0.403
30909,2015,46101,15140,22120,19294,2826,10110,9184,84297.44,0.415
30909,2016,46024,15764,22563,19389,3174,10117,9272,86981.89,0.411
30909,2017,47427,16397,22394,19345,3049,10147,9198,95218.11,0.411
30909,2018,47660,16906,22789,19519,3270,10349,9170,101946.22,0.402
30909,2019,48158,18071,23525,20175,3350,10263,9912,104572.78,0.421
30912,2010,8735,393,2105,1558,547,618,940,33844.0,0.447
30912,2011,7229,638,2016,1493,523,555,938,43667.0,0.465
30912,2012,6611,478,1956,1460,496,541,919,43133.0,0.47
30912,2013,6170,410,1892,1360,532,506,854,43002.5,0.451
30912,2014,6100,418,1819,1324,495,459,865,46380.0,0.476
30912,2015,6031,515,1809,1364,445,489,875,47355.0,0.484
30912,2016,5961,529,1834,1325,509,521,804,46292.5,0.438
30912,2017,6496,676,1771,1350,421,532,818,49279.0,0.462
30912,2018,6462,783,1657,1347,310,535,812,51146.0,0.49
30912,2019,6375,797,1644,1316,328,589,727,53826.5,0.442
30916,2010,14081,2174,6443,5540,903,3330,2210,43624.0,0.343
30916,2011,15495,2144,6553,5844,709,3306,2538,41901.0,0.387
30916,2012,16407,2791,6844,6026,818,3548,2478,43142.0,0.362
30916,2013,16213,2529,6974,6143,831,3486,2657,42651.0,0.381
30916,2014,15830,2522,6683,5907,776,2861,3046,37446.0,0.456
30916,2015,15835,2704,6693,5971,722,2830,3141,37031.0,0.469
30916,2016,15912,2422,6743,6038,705,2719,3319,37185.0,0.492
30916,2017,14706,1784,6892,6228,664,2677,3551,38223.0,0.515
30916,2018,15168,2361,6793,6339,454,2926,3413,41600.0,0.502
30916,2019,15147,2527,6913,6420,493,3168,3252,48051.0,0.47
31001,2010,21822,1598,8392,7356,1036,5738,1618,42514.0,0.193
31001,2011,21698,1750,8306,7402,904,5486,1916,42295.0,0.231
31001,2012,23914,1836,8982,8042,940,5806,2236,45088.0,0.249
31001,2013,24310,1866,8858,8008,850,5756,2252,44905.0,0.254
31001,2014,23582,1698,8592,7760,832,5316,2444,45913.0,0.284
31001,2015,23502,1420,8632,7800,832,4986,2814,44682.0,0.326
31001,2016,22684,1440,8798,8066,732,4622,3444,43181.0,0.391
31001,2017,21302,1516,8582,7946,636,4914,3032,42919.0,0.353
31001,2018,22776,1942,9114,8312,802,5238,3074,46799.0,0.337
31001,2019,22198,1864,8800,8062,738,5254,2808,49531.0,0.319
31002,2010,16527,1329,6998,6074,924,4408,1666,37026.0,0.238
31002,2011,16273,1391,6943,6012,931,4118,1894,36954.0,0.273
31002,2012,17308,1430,7121,6121,1000,4203,1918,38737.0,0.269
31002,2013,17621,1296,6962,6040,922,4045,1995,39206.5,0.287
31002,2014,17322,1161,6865,5967,898,3822,2145,39428.0,0.312
31002,2015,17289,1001,6958,5953,1005,3591,2362,37722.5,0.339
31002,2016,16789,1021,7123,6122,1001,3460,2662,37991.5,0.374
31002,2017,15857,1100,7040,6025,1015,3664,2361,37944.0,0.335
31002,2018,16475,1314,7353,6311,1042,3823,2488,39760.5,0.338
31002,2019,16152,1172,7063,6062,1001,3920,2142,42835.0,0.303
31006,2010,10911,799,4196,3678,518,2869,809,42514.0,0.193
31006,2011,10849,875,4153,3701,452,2743,958,42295.0,0.231
31006,2012,11957,918,4491,4021,470,2903,1118,45088.0,0.249
31006,2013,12155,933,4429,4004,425,2878,1126,44905.0,0.254
31006,2014,11791,849,4296,3880,416,2658,1222,45913.0,0.284
31006,2015,11751,710,4316,3900,416,2493,1407,44682.0,0.326
31006,2016,11342,720,4399,4033,366,2311,1722,43181.0,0.391
31006,2017,10651,758,4291,3973,318,2457,1516,42919.0,0.353
31006,2018,11388,971,4557,4156,401,2619,1537,46799.0,0.337
31006,2019,11099,932,4400,4031,369,2627,1404,49531.0,0.319
31007,2010,28351,2376,12832,10535,2297,7684,2851,41763.6,0.222
31007,2011,29077,2832,13096,10633,2463,7899,2734,42996.0,0.209
31007,2012,29556,3087,13198,10955,2243,8315,2640,43924.8,0.2
31007,2013,29956,3335,13256,11000,2256,8473,2527,44546.0,0.191
31007,2014,30578,3822,13442,11098,2344,8538,2560,44870.0,0.19
31007,2015,30665,4022,13511,11153,2358,8457,2696,44964.0,0.2
31007,2016,30718,4274,13427,11174,2253,8447,2727,45579.2,0.203
31007,2017,31445,4579,13627,11245,2382,8366,2879,47476.0,0.211
31007,2018,30957,4351,13546,11235,2311,8384,2851,49502.6,0.21
31007,2019,31554,4218,13692,11468,2224,8705,2763,51589.6,0.202
31008,2010,10966,1834,3659,3369,290,3186,183,90699.0,0.05
31008,2011,11461,2079,3802,3483,319,3278,205,92771.0,0.054
31008,2012,11350,2116,3689,3441,248,3209,232,93046.0,0.063
31008,2013,10975,2463,3684,3472,212,3203,269,81520.0,0.073
31008,2014,11143,2453,3707,3513,194,3251,262,81961.0,0.071
31008,2015,10778,2343,3640,3499,141,3236,263,80592.0,0.072
31008,2016,11264,2298,3661,3596,65,3215,381,79395.0,0.104
31008,2017,11410,2341,3767,3673,94,3279,394,82953.0,0.105
31008,2018,11694,2221,3800,3716,84,3341,375,92407.0,0.099
31008,2019,11535,2309,3917,3828,89,3396,432,102759.0,0.11
31010,2010,12000,1812,4554,4105,449,2960,1145,43127.0,0.251
31010,2011,11701,1948,4654,4066,588,3052,1014,51466.0,0.218
31010,2012,11873,1840,4595,4107,488,3007,1100,50462.0,0.239
31010,2013,11465,1699,4410,3937,473,2859,1078,51787.5,0.244
31010,2014,11465,1677,4451,3880,571,2921,959,49076.5,0.215
31010,2015,10941,1614,4523,3857,666,2943,914,52536.0,0.202
31010,2016,11046,1495,4460,3915,545,2862,1053,49611.5,0.236
31010,2017,11350,1671,4626,3964,662,3007,957,52335.5,0.207
31010,2018,11443,1514,4655,3993,662,2995,998,57056.5,0.214
31010,2019,11210,1465,4529,3935,594,2890,1045,65243.5,0.231
31011,2010,14745,1090,5421,4654,767,3684,970,48201.0,0.179
31011,2011,15085,1107,5455,4805,650,3687,1118,49332.0,0.205
31011,2012,15417,1131,5597,4960,637,3488,1472,49798.0,0.263
31011,2013,15275,1158,5625,5008,617,3407,1601,49427.0,0.285
31011,2014,14860,1384,5542,5024,518,3289,1735,46292.5,0.313
31011,2015,14802,1527,5505,5140,365,3278,1862,51408.5,0.338
31011,2016,14770,1413,5528,5073,455,3267,1806,53431.5,0.327
31011,2017,15579,1459,5729,5207,522,3451,1756,56248.0,0.307
31011,2018,14673,1421,5575,4986,589,3404,1582,60483.5,0.284
31011,2019,14823,1215,5584,4988,596,3494,1494,64146.0,0.268
31012,2010,10911,799,4196,3678,518,2869,809,42514.0,0.193
31012,2011,10849,875,4153,3701,452,2743,958,42295.0,0.231
31012,2012,11957,918,4491,4021,470,2903,1118,45088.0,0.249
31012,2013,12155,933,4429,4004,425,2878,1126,44905.0,0.254
31012,2014,11791,849,4296,3880,416,2658,1222,45913.0,0.284
31012,2015,11751,710,4316,3900,416,2493,1407,44682.0,0.326
31012,2016,11342,720,4399,4033,366,2311,1722,43181.0,0.391
31012,2017,10651,758,4291,3973,318,2457,1516,42919.0,0.353
31012,2018,11388,971,4557,4156,401,2619,1537,46799.0,0.337
31012,2019,11099,932,4400,4031,369,2627,1404,49531.0,0.319
31014,2010,18452,1581,6847,5945,902,4835,1110,48773.5,0.162
31014,2011,18633,1571,6710,5955,755,4701,1254,50196.0,0.187
31014,2012,19760,1732,7100,6302,798,4816,1486,52207.5,0.209
31014,2013,19465,1730,7033,6282,751,4855,1427,51554.0,0.203
31014,2014,18717,1546,6787,6115,672,4475,1640,49016.5,0.242
31014,2015,18391,1523,6802,6163,639,4247,1916,52556.0,0.282
31014,2016,18056,1405,6937,6317,620,4053,2264,51865.5,0.326
31014,2017,17818,1345,6934,6342,592,4374,1968,51279.0,0.284
31014,2018,17781,1433,7057,6313,744,4363,1950,55250.0,0.276
31014,2019,17551,1426,6939,6244,695,4474,1770,57553.5,0.255
31015,2010,73774,8012,30508,26217,4291,19635,6582,44581.67,0.216
31015,2011,74173,8405,30611,26167,4444,19916,6251,47040.4,0.204
31015,2012,75117,8560,31071,26485,4586,20080,6405,46709.73,0.206
31015,2013,74298,8424,30821,26334,4487,19960,6374,46660.4,0.207
31015,2014,72862,8331,30530,25973,4557,19579,6394,45752.33,0.209
31015,2015,72643,8234,30596,26079,4517,19356,6723,47710.13,0.22
31015,2016,72967,7805,30431,26205,4226,19206,6999,47144.33,0.23
31015,2017,73308,8028,30699,26402,4297,19390,7012,49553.33,0.228
31015,2018,73820,7876,31210,26770,4440,19518,7252,53177.2,0.232
31015,2019,74750,8290,31581,27401,4180,20074,7327,58591.0,0.232
31016,2010,10945,803,4723,3964,759,2871,1093,39337.0,0.231
31016,2011,10979,878,4730,3984,746,2825,1159,39211.5,0.245
31016,2012,11425,899,4792,4117,675,3039,1078,40018.0,0.225
31016,2013,10858,829,4687,3910,777,2942,968,40703.5,0.207
31016,2014,11293,1105,4605,3923,682,2959,964,41279.5,0.209
31016,2015,11031,1133,4580,3879,701,2749,1130,40085.5,0.247
31016,2016,11295,1125,4641,3879,762,2827,1052,44623.0,0.227
31016,2017,11713,1187,4645,3853,792,2792,1061,46002.0,0.228
31016,2018,11839,1217,4555,3908,647,2831,1077,48250.0,0.236
31016,2019,11764,1091,4516,3867,649,2884,983,50072.5,0.218
31023,2010,34578,3842,13882,11862,2020,8846,3016,47178.5,0.217
31023,2011,34564,3799,13927,12048,1879,8645,3403,46718.25,0.244
31023,2012,36180,3682,14098,12281,1817,8325,3956,47412.5,0.281
31023,2013,36123,3589,13883,12159,1724,8010,4149,46380.75,0.299
31023,2014,35666,3877,13745,12286,1459,7908,4378,46108.0,0.319
31023,2015,35876,3801,13663,12488,1175,7809,4679,48616.25,0.342
31023,2016,35243,3658,13734,12607,1127,7651,4956,49873.0,0.361
31023,2017,34840,3760,13674,12523,1151,7923,4600,51507.5,0.336
31023,2018,35066,4207,13991,12707,1284,8240,4467,55525.0,0.319
31023,2019,34814,3869,13749,12476,1273,8162,4314,57823.5,0.314
31024,2010,28450,3147,11370,9820,1550,7593,2227,48183.2,0.196
31024,2011,28650,3429,11317,9659,1658,7661,1998,54143.8,0.177
31024,2012,28912,3365,11459,9639,1820,7659,1980,56930.6,0.173
31024,2013,28570,3428,11526,9858,1668,7918,1940,55975.0,0.168
31024,2014,28020,3478,11371,9864,1507,7899,1965,59531.0,0.173
31024,2015,27248,3644,11409,9946,1463,7608,2338,57541.8,0.205
31024,2016,28427,3471,11531,10281,1250,7845,2436,57056.4,0.211
31024,2017,28752,3402,11778,10425,1353,8172,2253,58558.8,0.191
31024,2018,27511,3016,11571,10014,1557,7857,2157,61378.8,0.186
31024,2019,28736,3308,11887,10404,1483,8310,2094,64350.2,0.176
31028,2010,2023,1109,1251,1123,128,588,535,66838.0,0.428
31028,2011,2099,1195,1207,1092,115,562,530,67879.0,0.439
31028,2012,2065,1197,1206,1068,138,531,537,74113.0,0.445
31028,2013,2081,1187,1148,995,153,534,461,79289.0,0.402
31028,2014,2040,1224,1155,980,175,519,461,87500.0,0.399
31028,2015,2089,1238,1184,1025,159,571,454,102829.0,0.383
31028,2016,2139,1259,1190,994,196,577,417,95809.0,0.35
31028,2017,2045,1271,1153,984,169,582,402,87889.0,0.349
31028,2018,1899,1212,1145,970,175,538,432,84844.0,0.377
31028,2019,1881,1291,1135,983,152,571,412,84867.0,0.363
31029,2010,14340,1082,6461,5222,1239,3811,1411,46874.0,0.218
31029,2011,14654,1143,6458,5415,1043,4028,1387,45043.0,0.215
31029,2012,14839,1300,6646,5559,1087,4197,1362,46862.5,0.205
31029,2013,14799,1385,6651,5502,1149,4263,1239,47867.0,0.186
31029,2014,14444,1276,6639,5442,1197,4196,1246,46965.5,0.188
31029,2015,14185,1540,6300,5461,839,4234,1227,50071.0,0.195
31029,2016,14157,1550,6406,5390,1016,3980,1410,52298.0,0.22
31029,2017,14401,1577,6430,5602,828,3963,1639,52317.0,0.255
31029,2018,14772,1758,6596,5879,717,4014,1865,51747.5,0.283
31029,2019,15076,1962,6608,5881,727,4124,1757,56808.5,0.266
31030,2010,20737,4584,7917,6967,950,5575,1392,78934.33,0.176
31030,2011,20422,4727,7949,6852,1097,5500,1352,83176.33,0.17
31030,2012,20019,4631,7662,6689,973,5230,1459,82032.33,0.19
31030,2013,20056,4961,7730,6826,904,5354,1472,80123.0,0.19
31030,2014,20693,5086,7662,6790,872,5347,1443,81386.67,0.188
31030,2015,20259,5239,7608,6796,812,5388,1408,84701.33,0.185
31030,2016,21489,5180,7818,7173,645,5436,1737,83475.0,0.222
31030,2017,22622,5523,8188,7592,596,5659,1933,88531.0,0.236
31030,2018,22750,5546,8143,7566,577,5625,1941,93430.33,0.238
31030,2019,22685,5709,8270,7863,407,5639,2224,102152.0,0.269
31031,2010,23635,1919,9314,8002,1312,6338,1664,44130.33,0.179
31031,2011,24002,1850,9128,7944,1184,6089,1855,45314.67,0.203
31031,2012,25154,2080,9504,8331,1173,6220,2111,47159.67,0.222
31031,2013,24641,2049,9394,8257,1137,6222,2035,45139.0,0.217
31031,2014,23720,1790,9246,8178,1068,5834,2344,44419.33,0.254
31031,2015,23347,1789,9238,8093,1145,5557,2536,47067.33,0.275
31031,2016,23147,1725,9372,8288,1084,5401,2887,46038.67,0.308
31031,2017,22803,1608,9361,8305,1056,5727,2578,45520.33,0.275
31031,2018,22738,1726,9524,8208,1316,5627,2581,48381.33,0.271
31031,2019,22072,1690,9398,8037,1361,5642,2395,49521.33,0.255
31032,2010,18153,3594,7553,6496,1057,5674,822,64307.33,0.109
31032,2011,18505,3744,7937,6679,1258,5713,966,65276.0,0.122
31032,2012,19488,3744,8007,6962,1045,6001,961,64634.0,0.12
31032,2013,19884,3990,7903,7065,838,5727,1338,65437.33,0.169
31032,2014,20340,4352,8022,7359,663,5666,1693,64396.33,0.211
31032,2015,20564,4517,8067,7369,698,5510,1859,65978.0,0.23
31032,2016,20674,4921,7979,7511,468,5696,1815,69018.33,0.227
31032,2017,20994,5112,7975,7519,456,5545,1974,69204.0,0.248
31032,2018,20924,5074,8010,7496,514,5543,1953,69248.0,0.244
31032,2019,21160,5268,7976,7463,513,5564,1899,77267.0,0.238
31033,2010,10799,868,5269,4453,816,3042,1411,33191.0,0.268
31033,2011,10793,795,5208,4300,908,2763,1537,33582.5,0.295
31033,2012,10745,860,5034,4129,905,2704,1425,34725.0,0.283
31033,2013,10642,682,4894,4011,883,2534,1477,32908.5,0.302
31033,2014,10534,556,5028,4150,878,2523,1627,34084.0,0.324
31033,2015,10494,557,5078,3983,1095,2408,1575,33426.5,0.31
31033,2016,10538,621,5159,4060,1099,2497,1563,33593.5,0.303
31033,2017,10191,605,5176,4015,1161,2560,1455,33486.0,0.281
31033,2018,10044,636,5263,4050,1213,2468,1582,33683.0,0.301
31033,2019,9574,504,5122,3824,1298,2461,1363,34798.0,0.266
31035,2010,10911,799,4196,3678,518,2869,809,42514.0,0.193
31035,2011,10849,875,4153,3701,452,2743,958,42295.0,0.231
31035,2012,11957,918,4491,4021,470,2903,1118,45088.0,0.249
31035,2013,12155,933,4429,4004,425,2878,1126,44905.0,0.254
31035,2014,11791,849,4296,3880,416,2658,1222,45913.0,0.284
31035,2015,11751,710,4316,3900,416,2493,1407,44682.0,0.326
31035,2016,11342,720,4399,4033,366,2311,1722,43181.0,0.391
31035,2017,10651,758,4291,3973,318,2457,1516,42919.0,0.353
31035,2018,11388,971,4557,4156,401,2619,1537,46799.0,0.337
31035,2019,11099,932,4400,4031,369,2627,1404,49531.0,0.319
31036,2010,24947,2355,10760,8838,1922,6779,2059,46294.25,0.191
31036,2011,25882,2650,10923,8903,2020,7032,1871,48663.5,0.171
31036,2012,25934,3002,11015,9119,1896,7189,1930,49728.75,0.175
31036,2013,26408,3303,11173,9368,1805,7508,1860,49881.5,0.166
31036,2014,26211,3414,11328,9410,1918,7396,2014,48477.75,0.178
31036,2015,26274,3702,11417,9537,1880,7462,2075,51269.75,0.182
31036,2016,26137,3834,11324,9579,1745,7362,2217,49800.0,0.196
31036,2017,26899,3979,11625,9761,1864,7491,2270,51253.75,0.195
31036,2018,25511,3596,11491,9484,2007,7297,2187,53678.5,0.19
31036,2019,26242,3621,11715,9814,1901,7668,2146,55844.75,0.183
31037,2010,7204,308,2770,2387,383,1718,669,41369.0,0.242
31037,2011,7301,411,2898,2551,347,1729,822,40567.0,0.284
31037,2012,7614,317,2988,2679,309,1575,1104,40269.0,0.369
31037,2013,7965,361,3021,2730,291,1430,1300,40651.0,0.43
31037,2014,7934,687,3051,2789,262,1472,1317,40465.0,0.432
31037,2015,8162,714,3019,2877,142,1524,1353,42387.0,0.448
31037,2016,8056,728,2990,2789,201,1525,1264,46313.0,0.423
31037,2017,8412,872,3086,2838,248,1534,1304,52857.0,0.423
31037,2018,8280,959,3075,2829,246,1660,1169,57266.0,0.38
31037,2019,8371,721,3045,2775,270,1647,1128,62716.0,0.37
31038,2010,17180,1826,7068,5960,1108,4584,1376,42513.33,0.195
31038,2011,17432,1906,6909,5896,1013,4732,1164,46282.67,0.168
31038,2012,17799,1878,7056,5971,1085,4741,1230,47393.67,0.174
31038,2013,17285,1882,7062,5996,1066,4817,1179,48369.0,0.167
31038,2014,16763,1818,7031,5999,1032,4654,1345,49997.33,0.191
31038,2015,16556,1858,7045,6036,1009,4470,1566,54380.0,0.222
31038,2016,16781,1637,7195,6126,1069,4529,1597,53310.0,0.222
31038,2017,17218,1564,7388,6244,1144,4768,1476,53675.67,0.2
31038,2018,16322,1402,7311,6020,1291,4602,1418,55591.33,0.194
31038,2019,16953,1697,7431,6211,1220,4898,1313,61709.67,0.177
31041,2010,6141,3455,3103,2899,204,1783,1116,88021.0,0.36
31041,2011,5734,3437,3052,2733,319,1742,991,83406.0,0.325
31041,2012,5807,3316,2983,2711,272,1693,1018,88698.0,0.341
31041,2013,6081,3531,2986,2779,207,1811,968,94125.0,0.324
31041,2014,6101,3582,2983,2754,229,1885,869,101100.0,0.291
31041,2015,6278,3846,3015,2925,90,2032,893,100985.0,0.296
31041,2016,6275,3883,2985,2897,88,1977,920,106045.0,0.308
31041,2017,6282,3819,2871,2777,94,1945,832,116094.0,0.29
31041,2018,6291,3880,2835,2726,109,1863,863,128171.0,0.304
31041,2019,6175,3840,2806,2696,110,1941,755,158011.0,0.269
31042,2010,10911,799,4196,3678,518,2869,809,42514.0,0.193
31042,2011,10849,875,4153,3701,452,2743,958,42295.0,0.231
31042,2012,11957,918,4491,4021,470,2903,1118,45088.0,0.249
31042,2013,12155,933,4429,4004,425,2878,1126,44905.0,0.254
31042,2014,11791,849,4296,3880,416,2658,1222,45913.0,0.284
31042,2015,11751,710,4316,3900,416,2493,1407,44682.0,0.326
31042,2016,11342,720,4399,4033,366,2311,1722,43181.0,0.391
31042,2017,10651,758,4291,3973,318,2457,1516,42919.0,0.353
31042,2018,11388,971,4557,4156,401,2619,1537,46799.0,0.337
31042,2019,11099,932,4400,4031,369,2627,1404,49531.0,0.319
31044,2010,10911,799,4196,3678,518,2869,809,42514.0,0.193
31044,2011,10849,875,4153,3701,452,2743,958,42295.0,0.231
31044,2012,11957,918,4491,4021,470,2903,1118,45088.0,0.249
31044,2013,12155,933,4429,4004,425,2878,1126,44905.0,0.254
31044,2014,11791,849,4296,3880,416,2658,1222,45913.0,0.284
31044,2015,11751,710,4316,3900,416,2493,1407,44682.0,0.326
31044,2016,11342,720,4399,4033,366,2311,1722,43181.0,0.391
31044,2017,10651,758,4291,3973,318,2457,1516,42919.0,0.353
31044,2018,11388,971,4557,4156,401,2619,1537,46799.0,0.337
31044,2019,11099,932,4400,4031,369,2627,1404,49531.0,0.319
31045,2010,5616,530,2802,2396,406,1539,857,31538.0,0.306
31045,2011,5424,516,2790,2311,479,1375,936,31613.0,0.335
31045,2012,5351,512,2630,2100,530,1300,800,32386.0,0.304
31045,2013,5466,363,2533,2036,497,1167,869,33508.0,0.343
31045,2014,5531,312,2569,2087,482,1164,923,32943.0,0.359
31045,2015,5538,291,2642,2053,589,1098,955,30763.0,0.361
31045,2016,5447,301,2724,2089,635,1149,940,32802.0,0.345
31045,2017,5206,342,2749,2052,697,1207,845,32969.0,0.307
31045,2018,5087,343,2796,2155,641,1204,951,32722.0,0.34
31045,2019,5053,240,2663,2031,632,1293,738,36139.0,0.277
31049,2010,16561,1333,7525,6360,1165,4410,1950,36737.33,0.259
31049,2011,16403,1394,7520,6295,1225,4200,2095,36678.67,0.279
31049,2012,16776,1411,7422,6217,1205,4339,1878,37474.0,0.253
31049,2013,16324,1192,7220,5946,1274,4109,1837,38305.0,0.254
31049,2014,16824,1417,7174,6010,1164,4123,1887,38500.67,0.263
31049,2015,16569,1424,7222,5932,1290,3847,2085,36978.0,0.289
31049,2016,16742,1426,7365,5968,1397,3976,1992,40682.67,0.27
31049,2017,16919,1529,7394,5905,1489,3999,1906,41657.67,0.258
31049,2018,16926,1560,7351,6063,1288,4035,2028,43074.0,0.276
31049,2019,16817,1331,7179,5898,1281,4177,1721,45428.0,0.24
31051,2010,10945,803,4723,3964,759,2871,1093,39337.0,0.231
31051,2011,10979,878,4730,3984,746,2825,1159,39211.5,0.245
31051,2012,11425,899,4792,4117,675,3039,1078,40018.0,0.225
31051,2013,10858,829,4687,3910,777,2942,968,40703.5,0.207
31051,2014,11293,1105,4605,3923,682,2959,964,41279.5,0.209
31051,2015,11031,1133,4580,3879,701,2749,1130,40085.5,0.247
31051,2016,11295,1125,4641,3879,762,2827,1052,44623.0,0.227
31051,2017,11713,1187,4645,3853,792,2792,1061,46002.0,0.228
31051,2018,11839,1217,4555,3908,647,2831,1077,48250.0,0.236
31051,2019,11764,1091,4516,3867,649,2884,983,50072.5,0.218
31054,2010,18452,1581,6847,5945,902,4835,1110,48773.5,0.162
31054,2011,18633,1571,6710,5955,755,4701,1254,50196.0,0.187
31054,2012,19760,1732,7100,6302,798,4816,1486,52207.5,0.209
31054,2013,19465,1730,7033,6282,751,4855,1427,51554.0,0.203
31054,2014,18717,1546,6787,6115,672,4475,1640,49016.5,0.242
31054,2015,18391,1523,6802,6163,639,4247,1916,52556.0,0.282
31054,2016,18056,1405,6937,6317,620,4053,2264,51865.5,0.326
31054,2017,17818,1345,6934,6342,592,4374,1968,51279.0,0.284
31054,2018,17781,1433,7057,6313,744,4363,1950,55250.0,0.276
31054,2019,17551,1426,6939,6244,695,4474,1770,57553.5,0.255
31057,2010,6105,3728,3534,3078,456,2335,743,107523.5,0.21
31057,2011,6091,3796,3428,2953,475,2183,770,116160.0,0.225
31057,2012,5966,3568,3276,2846,430,2032,814,114906.0,0.248
31057,2013,5978,3477,3224,2825,399,2088,737,115878.5,0.229
31057,2014,6111,3478,3176,2681,495,2029,652,110425.5,0.205
31057,2015,6242,3675,3179,2660,519,2023,637,121023.5,0.2
31057,2016,6538,3714,3189,2721,468,2066,655,115318.5,0.205
31057,2017,6988,4019,3292,2903,389,2145,758,120653.5,0.23
31057,2018,7283,4144,3332,2995,337,2162,833,121941.0,0.25
31057,2019,7457,4379,3362,3103,259,2235,868,132826.5,0.258
31060,2010,16126,2261,7035,5917,1118,4011,1906,45583.5,0.271
31060,2011,15931,2228,7217,6093,1124,3944,2149,43240.5,0.298
31060,2012,16420,1950,6998,5979,1019,3509,2470,42617.5,0.353
31060,2013,16658,1859,6850,5877,973,3155,2722,41207.5,0.397
31060,2014,16949,2331,6958,6171,787,3433,2738,43199.5,0.394
31060,2015,17485,2278,6861,6325,536,3562,2763,44676.5,0.403
31060,2016,17187,2253,6797,6290,507,3598,2692,47880.5,0.396
31060,2017,17022,2415,6740,6181,559,3549,2632,51736.0,0.391
31060,2018,17285,2774,6934,6394,540,3877,2517,55800.0,0.363
31060,2019,17263,2443,6810,6232,578,3688,2544,58093.5,0.374
31061,2010,68844,5472,29819,24980,4839,18060,6920,40464.17,0.232
31061,2011,69359,5804,29898,24829,5069,17808,7021,41742.42,0.235
31061,2012,70662,6456,30249,25303,4946,18404,6899,42640.75,0.228
31061,2013,70748,6652,30093,25260,4833,18417,6843,42370.08,0.227
31061,2014,70190,7000,30060,25316,4744,18038,7278,41277.67,0.242
31061,2015,70127,7134,30089,25178,4911,17614,7564,42491.08,0.251
31061,2016,70044,7391,30208,25471,4737,17534,7937,42423.33,0.263
31061,2017,70295,7506,30521,25618,4903,17778,7840,42922.83,0.257
31061,2018,69822,7285,30749,25792,4957,17838,7954,45301.0,0.259
31061,2019,69792,6903,30624,25688,4936,18176,7512,47940.67,0.245
31063,2010,30023,3568,14156,11590,2566,8331,3259,51490.5,0.23
31063,2011,30841,4107,14407,11690,2717,8543,3147,53584.67,0.218
31063,2012,31297,4308,14419,11953,2466,8868,3085,54293.33,0.214
31063,2013,31615,4476,14463,11948,2515,9017,2931,54778.0,0.203
31063,2014,32220,4906,14612,11972,2640,9063,2909,52770.5,0.199
31063,2015,32257,5050,14646,11966,2680,8959,3007,54563.33,0.205
31063,2016,32475,5355,14571,12039,2532,9004,3035,53376.17,0.208
31063,2017,33250,5700,14821,12179,2642,8937,3242,54872.83,0.219
31063,2018,32867,5528,14727,12233,2494,9012,3221,56080.67,0.219
31063,2019,33601,5455,14914,12487,2427,9368,3119,59200.83,0.209
31064,2010,48881,4415,20371,17618,2753,13640,3978,44974.36,0.195
31064,2011,50482,5084,20752,17914,2838,14015,3899,46175.18,0.188
31064,2012,50806,4798,21129,18255,2874,14322,3933,46384.36,0.186
31064,2013,51124,5172,20988,18266,2722,14363,3903,46433.55,0.186
31064,2014,51250,5350,21084,18210,2874,14172,4038,47363.55,0.192
31064,2015,51528,5147,21082,18246,2836,14060,4186,48836.55,0.199
31064,2016,51816,4874,21299,18582,2717,14173,4409,48268.45,0.207
31064,2017,51904,5111,21535,18772,2763,14057,4715,51557.73,0.219
31064,2018,52788,5177,21803,19122,2681,14451,4671,53491.36,0.214
31064,2019,53337,5739,22003,19358,2645,14612,4746,58183.45,0.216
31068,2010,6141,3455,3103,2899,204,1783,1116,88021.0,0.36
31068,2011,5734,3437,3052,2733,319,1742,991,83406.0,0.325
31068,2012,5807,3316,2983,2711,272,1693,1018,88698.0,0.341
31068,2013,6081,3531,2986,2779,207,1811,968,94125.0,0.324
31068,2014,6101,3582,2983,2754,229,1885,869,101100.0,0.291
31068,2015,6278,3846,3015,2925,90,2032,893,100985.0,0.296
31068,2016,6275,3883,2985,2897,88,1977,920,106045.0,0.308
31068,2017,6282,3819,2871,2777,94,1945,832,116094.0,0.29
31068,2018,6291,3880,2835,2726,109,1863,863,128171.0,0.304
31068,2019,6175,3840,2806,2696,110,1941,755,158011.0,0.269
31069,2010,7792,4625,4284,3748,536,2856,892,107202.0,0.208
31069,2011,8182,4806,4275,3780,495,2810,970,107313.5,0.227
31069,2012,8297,4829,4309,3822,487,2762,1060,106748.5,0.246
31069,2013,8546,4869,4328,3879,449,2763,1116,101760.5,0.258
31069,2014,8726,5076,4485,3903,582,2876,1027,94371.0,0.229
31069,2015,8896,4864,4482,3946,536,2902,1044,98936.5,0.233
31069,2016,9253,5000,4467,3979,488,2893,1086,93804.0,0.243
31069,2017,9898,5152,4473,3948,525,2818,1130,95892.5,0.253
31069,2018,10306,5507,4654,4217,437,3111,1106,101343.5,0.238
31069,2019,11107,6011,4769,4374,395,3194,1180,112607.0,0.247
31070,2010,36374,2775,16186,13394,2792,9417,3977,40287.29,0.246
31070,2011,36961,3238,16449,13451,2998,9590,3861,41793.86,0.235
31070,2012,37120,3656,16515,13674,2841,10017,3657,42589.86,0.221
31070,2013,37398,3948,16564,13708,2856,10161,3547,42879.14,0.214
31070,2014,37607,4503,16682,13809,2873,10215,3594,41248.0,0.215
31070,2015,37703,4633,16674,13790,2884,10083,3707,42592.43,0.222
31070,2016,37809,4860,16611,13805,2806,10090,3715,42881.86,0.224
31070,2017,38236,5043,16862,13867,2995,9950,3917,43842.29,0.232
31070,2018,38222,4741,16893,14064,2829,10059,4005,46904.57,0.237
31070,2019,38856,4534,17056,14261,2795,10328,3933,50372.71,0.231
31071,2010,18934,1198,7550,6537,1013,4602,1935,38569.0,0.256
31071,2011,18733,1281,7506,6519,987,4434,2085,39957.33,0.278
31071,2012,19521,1487,7808,6740,1068,4605,2135,41197.67,0.273
31071,2013,19597,1546,7737,6712,1025,4566,2146,40776.33,0.277
31071,2014,18820,1530,7536,6591,945,4335,2256,36766.33,0.299
31071,2015,18789,1321,7479,6537,942,4119,2418,39336.33,0.323
31071,2016,18433,1306,7583,6664,919,3954,2710,38486.0,0.357
31071,2017,17442,1222,7526,6595,931,4041,2554,37478.33,0.339
31071,2018,18653,1361,7904,6985,919,4294,2691,42539.33,0.34
31071,2019,18401,1248,7764,6824,940,4250,2574,48064.0,0.332
31072,2010,54292,5318,20830,18277,2553,13730,4547,44366.2,0.218
31072,2011,54211,5844,21006,18412,2594,13807,4605,47121.2,0.219
31072,2012,54920,5935,21335,18693,2642,13922,4771,46697.5,0.224
31072,2013,54087,5821,21148,18671,2477,13931,4740,46450.9,0.224
31072,2014,53011,5637,20838,18460,2378,13597,4863,44021.2,0.233
31072,2015,51937,5410,20816,18365,2451,13339,5026,46736.9,0.241
31072,2016,51817,4833,20893,18563,2330,13076,5487,44913.1,0.263
31072,2017,51835,4933,21160,18724,2436,13477,5247,47274.6,0.248
31072,2018,53074,4875,21588,19049,2539,13695,5354,51847.5,0.248
31072,2019,52398,4909,21328,18794,2534,13665,5129,57511.4,0.24
31076,2010,11479,3669,5151,4474,677,2484,1990,59601.5,0.386
31076,2011,10368,3564,5082,4206,876,2425,1781,57186.0,0.35
31076,2012,10251,3484,4901,4111,790,2235,1876,59036.5,0.383
31076,2013,10843,3693,5015,4256,759,2418,1838,63577.5,0.367
31076,2014,11182,3821,4932,4224,708,2477,1747,67360.5,0.354
31076,2015,11109,4095,4939,4375,564,2663,1712,67505.0,0.347
31076,2016,11719,4132,5097,4618,479,2689,1929,69399.5,0.378
31076,2017,12311,4103,5194,4727,467,2751,1976,74642.0,0.38
31076,2018,11974,4238,5027,4579,448,2613,1966,80572.0,0.391
31076,2019,11915,4098,5019,4647,372,2612,2035,96656.0,0.405
31077,2010,8922,1953,4265,3530,735,2293,1237,49798.0,0.29
31077,2011,8630,1817,4319,3542,777,2215,1327,45914.0,0.307
31077,2012,8806,1633,4010,3300,710,1934,1366,44966.0,0.341
31077,2013,8693,1498,3829,3147,682,1725,1422,41764.0,0.371
31077,2014,9015,1644,3907,3382,525,1961,1421,45934.0,0.364
31077,2015,9323,1564,3842,3448,394,2038,1410,46966.0,0.367
31077,2016,9131,1525,3807,3501,306,2073,1428,49448.0,0.375
31077,2017,8610,1543,3654,3343,311,2015,1328,50615.0,0.363
31077,2018,9005,1815,3859,3565,294,2217,1348,54334.0,0.349
31077,2019,8892,1722,3765,3457,308,2041,1416,53471.0,0.376
31078,2010,10966,1834,3659,3369,290,3186,183,90699.0,0.05
31078,2011,11461,2079,3802,3483,319,3278,205,92771.0,0.054
31078,2012,11350,2116,3689,3441,248,3209,232,93046.0,0.063
31078,2013,10975,2463,3684,3472,212,3203,269,81520.0,0.073
31078,2014,11143,2453,3707,3513,194,3251,262,81961.0,0.071
31078,2015,10778,2343,3640,3499,141,3236,263,80592.0,0.072
31078,2016,11264,2298,3661,3596,65,3215,381,79395.0,0.104
31078,2017,11410,2341,3767,3673,94,3279,394,82953.0,0.105
31078,2018,11694,2221,3800,3716,84,3341,375,92407.0,0.099
31078,2019,11535,2309,3917,3828,89,3396,432,102759.0,0.11
31079,2010,41363,4192,15597,13728,1869,10664,3064,45263.0,0.196
31079,2011,41183,4394,15517,13722,1795,10496,3226,49123.8,0.208
31079,2012,43590,4490,16186,14430,1756,10726,3704,50085.4,0.229
31079,2013,43085,4362,15872,14223,1649,10592,3631,50317.6,0.229
31079,2014,41973,4072,15534,13875,1659,10054,3821,48419.8,0.246
31079,2015,41083,3847,15641,13920,1721,9683,4237,50973.2,0.271
31079,2016,40444,3620,15796,14265,1531,9226,5039,49227.0,0.319
31079,2017,39819,3774,15851,14279,1572,9838,4441,50029.6,0.28
31079,2018,40612,3918,16269,14462,1807,9977,4485,54282.4,0.276
31079,2019,39860,3823,15868,14210,1658,9991,4219,59025.0,0.266
31081,2010,17052,4254,7299,6577,722,4652,1925,65267.5,0.264
31081,2011,16583,4312,7205,6434,771,4485,1949,62850.5,0.271
31081,2012,17764,4234,7474,6732,742,4596,2136,66893.0,0.286
31081,2013,18236,4464,7415,6783,632,4689,2094,69515.0,0.282
31081,2014,17892,4431,7279,6634,645,4543,2091,73506.5,0.287
31081,2015,18029,4556,7331,6825,506,4525,2300,72833.5,0.314
31081,2016,17617,4603,7384,6930,454,4288,2642,74613.0,0.358
31081,2017,16933,4577,7162,6750,412,4402,2348,79506.5,0.328
31081,2018,17679,4851,7392,6882,510,4482,2400,87485.0,0.325
31081,2019,17274,4772,7206,6727,479,4568,2159,103771.0,0.3
31082,2010,17406,1573,8109,6571,1538,4813,1758,43381.33,0.217
31082,2011,18098,1954,8366,6649,1717,5074,1575,45519.0,0.188
31082,2012,18131,2188,8406,6838,1568,5276,1562,46529.33,0.186
31082,2013,19098,2506,8569,7090,1479,5531,1559,47107.67,0.182
31082,2014,19285,2717,8837,7175,1662,5579,1596,47263.67,0.181
31082,2015,19634,2889,8931,7274,1657,5708,1566,48216.33,0.175
31082,2016,19423,3149,8786,7295,1491,5620,1675,46216.67,0.191
31082,2017,19732,3392,8982,7392,1590,5574,1818,48458.67,0.202
31082,2018,19118,3134,8991,7327,1664,5553,1774,50337.67,0.197
31082,2019,19790,3127,9176,7601,1575,5821,1780,52601.0,0.194
31085,2010,30337,2783,12332,10690,1642,8312,2378,46457.88,0.193
31085,2011,31218,3210,12744,11057,1687,8593,2464,46955.5,0.193
31085,2012,31180,3198,12965,11396,1569,8894,2502,47147.88,0.193
31085,2013,31517,3422,13012,11530,1482,9076,2454,47106.38,0.189
31085,2014,31987,3430,13036,11450,1586,9080,2370,47249.88,0.182
31085,2015,31866,3212,12972,11414,1558,9088,2326,48186.12,0.179
31085,2016,31898,3006,12961,11502,1459,9140,2362,47975.62,0.182
31085,2017,31635,3058,13065,11502,1563,8863,2639,51800.0,0.202
31085,2018,32326,3099,13143,11642,1501,9056,2586,54511.75,0.197
31085,2019,32024,3479,13225,11705,1520,9151,2554,58064.62,0.193
31087,2010,17406,1573,8109,6571,1538,4813,1758,43381.33,0.217
31087,2011,18098,1954,8366,6649,1717,5074,1575,45519.0,0.188
31087,2012,18131,2188,8406,6838,1568,5276,1562,46529.33,0.186
31087,2013,19098,2506,8569,7090,1479,5531,1559,47107.67,0.182
31087,2014,19285,2717,8837,7175,1662,5579,1596,47263.67,0.181
31087,2015,19634,2889,8931,7274,1657,5708,1566,48216.33,0.175
31087,2016,19423,3149,8786,7295,1491,5620,1675,46216.67,0.191
31087,2017,19732,3392,8982,7392,1590,5574,1818,48458.67,0.202
31087,2018,19118,3134,8991,7327,1664,5553,1774,50337.67,0.197
31087,2019,19790,3127,9176,7601,1575,5821,1780,52601.0,0.194
31088,2010,13963,5448,7806,6715,1091,4363,2352,53367.6,0.301
31088,2011,14170,5639,7563,6484,1079,4112,2372,53584.0,0.314
31088,2012,14109,5659,7436,6425,1011,3971,2454,54740.2,0.33
31088,2013,13827,5534,7360,6300,1060,3868,2432,57217.0,0.33
31088,2014,14094,5713,7291,6234,1057,3657,2577,60356.8,0.353
31088,2015,14668,6046,7449,6543,906,3722,2821,63909.2,0.379
31088,2016,14651,6440,7681,6771,910,3882,2889,65212.8,0.376
31088,2017,14763,6587,7775,6817,958,4004,2813,66046.8,0.362
31088,2018,14553,6785,7770,6831,939,4075,2756,70256.2,0.355
31088,2019,15193,7479,7847,6991,856,4432,2559,84263.6,0.326
31089,2010,7541,782,2651,2267,384,1966,301,55033.0,0.114
31089,2011,7784,696,2557,2254,303,1958,296,58097.0,0.116
31089,2012,7803,814,2609,2281,328,1913,368,59327.0,0.141
31089,2013,7310,797,2604,2278,326,1977,301,58203.0,0.116
31089,2014,6926,697,2491,2235,256,1817,418,52120.0,0.168
31089,2015,6640,813,2486,2263,223,1754,509,60430.0,0.205
31089,2016,6714,685,2538,2284,254,1742,542,60550.0,0.214
31089,2017,7167,587,2643,2369,274,1917,452,59639.0,0.171
31089,2018,6393,462,2500,2157,343,1744,413,63701.0,0.165
31089,2019,6452,494,2539,2213,326,1847,366,65576.0,0.144
31090,2010,10911,799,4196,3678,518,2869,809,42514.0,0.193
31090,2011,10849,875,4153,3701,452,2743,958,42295.0,0.231
31090,2012,11957,918,4491,4021,470,2903,1118,45088.0,0.249
31090,2013,12155,933,4429,4004,425,2878,1126,44905.0,0.254
31090,2014,11791,849,4296,3880,416,2658,1222,45913.0,0.284
31090,2015,11751,710,4316,3900,416,2493,1407,44682.0,0.326
31090,2016,11342,720,4399,4033,366,2311,1722,43181.0,0.391
31090,2017,10651,758,4291,3973,318,2457,1516,42919.0,0.353
31090,2018,11388,971,4557,4156,401,2619,1537,46799.0,0.337
31090,2019,11099,932,4400,4031,369,2627,1404,49531.0,0.319
31091,2010,27101,3164,12787,10485,2302,7193,3292,50577.0,0.257
31091,2011,27746,3635,13030,10524,2506,7409,3115,53443.67,0.239
31091,2012,27436,3978,12944,10555,2389,7531,3024,54038.17,0.234
31091,2013,28199,4260,13084,10746,2338,7763,2983,54114.17,0.228
31091,2014,27956,4482,13247,10760,2487,7781,2979,49741.67,0.225
31091,2015,28264,4528,13229,10724,2505,7836,2888,53422.67,0.218
31091,2016,28271,4816,13114,10791,2323,7820,2971,50548.0,0.227
31091,2017,28328,4977,13411,10948,2463,7729,3219,51124.83,0.24
31091,2018,28293,4701,13519,11154,2365,7856,3298,53467.17,0.244
31091,2019,29139,4680,13762,11413,2349,8107,3306,58286.83,0.24
31092,2010,63102,5100,26457,22440,4017,16488,5952,42599.42,0.225
31092,2011,63803,6032,26891,22725,4166,16696,6029,43763.58,0.224
31092,2012,64800,6368,27329,23260,4069,17317,5943,43862.33,0.217
31092,2013,65268,6660,27390,23456,3934,17568,5888,43788.42,0.215
31092,2014,65198,7085,27338,23443,3895,17397,6046,42857.42,0.221
31092,2015,65021,7005,27318,23398,3920,17099,6299,43890.58,0.231
31092,2016,64775,6927,27322,23538,3784,16919,6619,43104.5,0.242
31092,2017,64763,7254,27518,23636,3882,16919,6717,45484.67,0.244
31092,2018,66195,7250,27979,24134,3845,17340,6794,49014.5,0.243
31092,2019,66290,7168,27952,24114,3838,17633,6481,53083.25,0.232
31093,2010,15752,6943,8304,7290,1014,4922,2368,66264.0,0.285
31093,2011,16044,7035,8057,7083,974,4639,2444,66743.8,0.303
31093,2012,15848,6987,7906,7003,903,4453,2550,66924.8,0.323
31093,2013,15650,6867,7844,6918,926,4363,2555,68787.6,0.326
31093,2014,15801,7062,7795,6848,947,4185,2663,71952.8,0.342
31093,2015,16242,7378,7995,7196,799,4273,2923,74117.6,0.366
31093,2016,16451,7805,8242,7422,820,4484,2938,75329.6,0.356
31093,2017,16683,8023,8357,7515,842,4671,2844,77897.8,0.34
31093,2018,16485,8076,8308,7422,886,4636,2786,83785.0,0.335
31093,2019,17035,8692,8341,7608,733,4979,2629,94703.0,0.315
31096,2010,18452,1581,6847,5945,902,4835,1110,48773.5,0.162
31096,2011,18633,1571,6710,5955,755,4701,1254,50196.0,0.187
31096,2012,19760,1732,7100,6302,798,4816,1486,52207.5,0.209
31096,2013,19465,1730,7033,6282,751,4855,1427,51554.0,0.203
31096,2014,18717,1546,6787,6115,672,4475,1640,49016.5,0.242
31096,2015,18391,1523,6802,6163,639,4247,1916,52556.0,0.282
31096,2016,18056,1405,6937,6317,620,4053,2264,51865.5,0.326
31096,2017,17818,1345,6934,6342,592,4374,1968,51279.0,0.284
31096,2018,17781,1433,7057,6313,744,4363,1950,55250.0,0.276
31096,2019,17551,1426,6939,6244,695,4474,1770,57553.5,0.255
31097,2010,26762,2329,10798,9332,1466,7073,2259,44223.67,0.209
31097,2011,26972,2797,11019,9557,1462,7188,2369,44789.0,0.215
31097,2012,27148,2693,11115,9682,1433,7436,2246,43861.17,0.202
31097,2013,26573,2608,11084,9654,1430,7471,2183,43634.83,0.197
31097,2014,27093,2838,10965,9677,1288,7483,2194,43699.83,0.2
31097,2015,26598,2795,10908,9587,1321,7272,2315,44004.83,0.212
31097,2016,26919,2472,10953,9579,1374,7345,2234,43857.67,0.204
31097,2017,27589,2640,11010,9649,1361,7304,2345,48000.83,0.213
31097,2018,28424,2755,11084,9822,1262,7493,2329,51590.5,0.21
31097,2019,28099,2793,11012,9689,1323,7562,2127,55834.0,0.193
31098,2010,6365,2383,3633,3022,611,1876,1146,54176.33,0.315
31098,2011,6197,2443,3498,2902,596,1690,1212,50998.67,0.346
31098,2012,6242,2614,3446,2873,573,1667,1206,53751.67,0.35
31098,2013,6040,2757,3452,2868,584,1650,1218,56518.0,0.353
31098,2014,6378,2853,3411,2913,498,1542,1371,56041.0,0.402
31098,2015,6879,3205,3497,3102,395,1616,1486,56060.67,0.425
31098,2016,6966,3223,3676,3324,352,1646,1678,55082.33,0.456
31098,2017,6907,3245,3686,3232,454,1645,1587,58603.0,0.431
31098,2018,6863,3331,3678,3250,428,1793,1457,65997.33,0.396
31098,2019,7385,3568,3743,3266,477,2012,1254,88277.67,0.335
31106,2010,6141,3455,3103,2899,204,1783,1116,88021.0,0.36
31106,2011,5734,3437,3052,2733,319,1742,991,83406.0,0.325
31106,2012,5807,3316,2983,2711,272,1693,1018,88698.0,0.341
31106,2013,6081,3531,2986,2779,207,1811,968,94125.0,0.324
31106,2014,6101,3582,2983,2754,229,1885,869,101100.0,0.291
31106,2015,6278,3846,3015,2925,90,2032,893,100985.0,0.296
31106,2016,6275,3883,2985,2897,88,1977,920,106045.0,0.308
31106,2017,6282,3819,2871,2777,94,1945,832,116094.0,0.29
31106,2018,6291,3880,2835,2726,109,1863,863,128171.0,0.304
31106,2019,6175,3840,2806,2696,110,1941,755,158011.0,0.269
31107,2010,2570,1377,1350,1184,166,801,383,78015.0,0.284
31107,2011,2540,1421,1301,1158,143,754,404,81814.0,0.311
31107,2012,2564,1432,1289,1158,131,744,414,82038.0,0.321
31107,2013,2428,1478,1261,1154,107,719,435,83378.0,0.345
31107,2014,2451,1543,1257,1169,88,695,474,83720.0,0.377
31107,2015,2585,1644,1297,1234,63,742,492,78897.0,0.379
31107,2016,2520,1634,1355,1312,43,763,549,77000.0,0.405
31107,2017,2574,1584,1361,1294,67,745,549,78681.0,0.403
31107,2018,2585,1543,1365,1269,96,772,497,82882.0,0.364
31107,2019,2701,1586,1342,1245,97,841,404,106103.0,0.301
31119,2010,3425,1389,1680,1520,160,882,638,63821.0,0.38
31119,2011,3284,1484,1634,1417,217,866,551,80284.0,0.337
31119,2012,3093,1504,1623,1345,278,878,467,90625.0,0.288
31119,2013,3331,1617,1652,1370,282,986,384,97500.0,0.232
31119,2014,3569,1902,1704,1439,265,1026,413,103717.0,0.242
31119,2015,3874,2068,1724,1530,194,1094,436,103155.0,0.253
31119,2016,3646,2070,1560,1443,117,1010,433,114107.0,0.278
31119,2017,3667,2035,1519,1410,109,1031,379,119297.0,0.25
31119,2018,3734,2092,1545,1460,85,1103,357,114695.0,0.231
31119,2019,3764,2037,1533,1405,128,1124,281,115759.0,0.183
31126,2010,4037,2279,2936,2236,700,1237,999,95222.0,0.34
31126,2011,4186,2378,3071,2371,700,1179,1192,88365.0,0.388
31126,2012,4551,2572,3101,2574,527,1235,1339,81711.0,0.432
31126,2013,4672,2941,3151,2659,492,1377,1282,96696.0,0.407
31126,2014,4717,2949,3226,2688,538,1346,1342,91875.0,0.416
31126,2015,4625,2955,3289,2703,586,1345,1358,95559.0,0.413
31126,2016,5018,2902,3300,2787,513,1461,1326,100142.0,0.402
31126,2017,4953,2847,3323,2746,577,1454,1292,101689.0,0.389
31126,2018,5078,2930,3370,2834,536,1420,1414,91452.0,0.42
31126,2019,5514,3264,3604,3112,492,1506,1606,102778.0,0.446
31131,2010,3521,1074,1838,1613,225,1128,485,46563.0,0.264
31131,2011,3477,986,1820,1516,304,1095,421,43716.0,0.231
31131,2012,3590,876,1809,1423,386,969,454,40547.0,0.251
31131,2013,3896,963,1810,1501,309,971,530,36971.0,0.293
31131,2014,3759,861,1784,1481,303,921,560,40793.0,0.314
31131,2015,4152,878,1772,1499,273,895,604,43531.0,0.341
31131,2016,4420,807,1799,1543,256,872,671,40058.0,0.373
31131,2017,4403,759,1805,1518,287,866,652,42150.0,0.361
31131,2018,4220,723,1824,1529,295,894,635,43381.0,0.348
31131,2019,4463,860,1855,1601,254,945,656,44452.0,0.354
31136,2010,8902,2746,3454,3104,350,2262,842,69714.0,0.244
31136,2011,9318,2768,3603,3159,444,2186,973,70961.0,0.27
31136,2012,9247,2864,3749,3260,489,2212,1048,74854.0,0.28
31136,2013,9746,2941,3885,3352,533,2111,1241,71333.0,0.319
31136,2014,10181,3276,4018,3542,476,2279,1263,70352.0,0.314
31136,2015,9494,3097,4107,3462,645,2167,1295,56698.0,0.315
31136,2016,10275,3376,4212,3709,503,2504,1205,61804.0,0.286
31136,2017,10581,3325,4325,3974,351,2826,1148,63209.0,0.265
31136,2018,10933,3562,4383,4036,347,2928,1108,68540.0,0.253
31136,2019,10840,3715,4493,4104,389,2886,1218,71457.0,0.271
31139,2010,4437,2186,2944,2599,345,372,2227,54455.0,0.756
31139,2011,5044,2616,3153,2893,260,398,2495,56803.0,0.791
31139,2012,5383,2470,3328,3050,278,466,2584,56776.0,0.776
31139,2013,5296,2386,3337,3000,337,453,2547,56409.0,0.763
31139,2014,5599,2629,3415,3078,337,386,2692,54437.0,0.788
31139,2015,5862,2769,3447,3217,230,473,2744,55785.0,0.796
31139,2016,5819,2616,3443,3196,247,569,2627,54700.0,0.763
31139,2017,5669,2882,3386,3094,292,550,2544,61542.0,0.751
31139,2018,6145,3282,3604,3307,297,511,2796,66580.0,0.776
31139,2019,6362,3444,3766,3485,281,476,3009,75532.0,0.799
31141,2010,5196,1550,2899,2588,311,655,1933,41199.0,0.667
31141,2011,4368,1598,2613,2276,337,694,1582,41256.0,0.605
31141,2012,4576,1524,2757,2276,481,715,1561,41412.0,0.566
31141,2013,5140,1757,2848,2391,457,814,1577,44645.0,0.554
31141,2014,4970,1540,2853,2296,557,721,1575,43500.0,0.552
31141,2015,4731,1572,2843,2257,586,668,1589,36660.0,0.559
31141,2016,4755,1504,2772,2177,595,729,1448,41692.0,0.522
31141,2017,5009,1515,2743,2140,603,796,1344,41481.0,0.49
31141,2018,4782,1375,2646,2063,583,826,1237,39685.0,0.467
31141,2019,4879,1330,2622,2117,505,894,1223,42679.0,0.466
31145,2010,4817,2102,2400,2123,277,1611,512,77411.0,0.213
31145,2011,5081,2437,2581,2316,265,1661,655,77672.0,0.254
31145,2012,5101,2509,2610,2345,265,1554,791,80132.0,0.303
31145,2013,5484,2586,2672,2395,277,1653,742,78622.0,0.278
31145,2014,5361,2662,2748,2366,382,1544,822,76703.0,0.299
31145,2015,5148,2726,2818,2417,401,1511,906,72217.0,0.322
31145,2016,5373,2782,2882,2496,386,1558,938,68188.0,0.325
31145,2017,5593,2729,2949,2589,360,1604,985,68837.0,0.334
31145,2018,5670,2813,2943,2644,299,1559,1085,71989.0,0.369
31145,2019,5788,2950,2912,2708,204,1672,1036,74539.0,0.356
31146,2010,6794,3136,3986,3625,361,1138,2487,57820.0,0.624
31146,2011,7418,3327,4198,3783,415,1147,2636,54634.0,0.628
31146,2012,7770,3470,4410,3814,596,1045,2769,59201.0,0.628
31146,2013,8279,4394,4685,4095,590,1079,3016,63595.0,0.644
31146,2014,8528,4492,4793,4107,686,1125,2982,62788.0,0.622
31146,2015,8540,4503,4893,4128,765,964,3164,65934.0,0.647
31146,2016,8057,4802,5077,4109,968,795,3314,81554.0,0.653
31146,2017,7834,4966,5110,4078,1032,836,3242,84889.0,0.634
31146,2018,7850,4953,5045,3941,1104,799,3142,92670.0,0.623
31146,2019,7974,4936,5054,4112,942,842,3270,86828.0,0.647
31150,2010,4839,970,2344,1838,506,280,1558,41335.0,0.665
31150,2011,5166,1008,2304,1868,436,205,1663,40673.0,0.722
31150,2012,5152,949,2298,1848,450,216,1632,36274.0,0.71
31150,2013,5081,1032,2274,1935,339,276,1659,35736.0,0.73
31150,2014,5265,1101,2357,2071,286,286,1785,36659.0,0.757
31150,2015,5084,1136,2399,2138,261,306,1832,40596.0,0.764
31150,2016,4835,1115,2492,2239,253,431,1808,42043.0,0.726
31150,2017,5314,1380,2504,2312,192,483,1829,43621.0,0.73
31150,2018,6002,1534,2589,2359,230,500,1859,48530.0,0.718
31150,2019,6351,1832,2597,2408,189,623,1785,56402.0,0.687
31156,2010,2801,905,1849,1511,338,201,1310,50554.0,0.708
31156,2011,2932,815,1792,1531,261,179,1352,41123.0,0.754
31156,2012,2872,861,1815,1501,314,205,1296,43297.0,0.714
31156,2013,2954,905,1820,1568,252,196,1372,43949.0,0.754
31156,2014,3005,912,1844,1577,267,142,1435,43986.0,0.778
31156,2015,3332,1034,1839,1686,153,191,1495,44563.0,0.813
31156,2016,3568,1300,1918,1834,84,209,1625,50789.0,0.847
31156,2017,3969,1300,1941,1902,39,200,1702,55782.0,0.877
31156,2018,4286,1495,1984,1939,45,278,1661,58725.0,0.837
31156,2019,4319,1550,2025,1962,63,293,1669,60731.0,0.824
31201,2010,80784,9264,34923,29735,5188,21207,8528,43870.06,0.244
31201,2011,82299,9848,35669,30084,5585,21711,8373,45382.17,0.235
31201,2012,83675,9935,36330,30848,5482,22235,8613,45618.33,0.237
31201,2013,84443,10102,36369,30945,5424,21942,9003,45608.56,0.248
31201,2014,84446,10218,36473,30718,5755,21669,9049,46074.39,0.248
31201,2015,85079,10072,36874,31192,5682,21662,9530,47411.28,0.258
31201,2016,85339,10168,36862,31598,5264,21566,10032,47264.11,0.272
31201,2017,85020,10412,36882,31446,5436,21339,10107,50189.11,0.274
31201,2018,85818,10714,37420,31990,5430,21889,10101,52913.28,0.27
31201,2019,86779,11402,37956,32893,5063,22414,10479,56603.67,0.276
31203,2010,12000,1812,4554,4105,449,2960,1145,43127.0,0.251
31203,2011,11701,1948,4654,4066,588,3052,1014,51466.0,0.218
31203,2012,11873,1840,4595,4107,488,3007,1100,50462.0,0.239
31203,2013,11465,1699,4410,3937,473,2859,1078,51787.5,0.244
31203,2014,11465,1677,4451,3880,571,2921,959,49076.5,0.215
31203,2015,10941,1614,4523,3857,666,2943,914,52536.0,0.202
31203,2016,11046,1495,4460,3915,545,2862,1053,49611.5,0.236
31203,2017,11350,1671,4626,3964,662,3007,957,52335.5,0.207
31203,2018,11443,1514,4655,3993,662,2995,998,57056.5,0.214
31203,2019,11210,1465,4529,3935,594,2890,1045,65243.5,0.231
31204,2010,82676,9678,37298,30933,6365,21277,9656,41499.5,0.259
31204,2011,84171,10430,37659,31069,6590,21686,9383,43185.4,0.249
31204,2012,85546,10732,38266,31969,6297,22081,9888,43234.8,0.258
31204,2013,85655,10641,38308,31989,6319,21874,10115,42699.3,0.264
31204,2014,85946,10765,38549,31832,6717,21575,10257,42908.95,0.266
31204,2015,86555,10623,38615,32180,6435,21514,10666,44810.15,0.276
31204,2016,86700,10595,38323,32427,5896,21451,10976,44838.6,0.286
31204,2017,86045,10839,38506,32279,6227,21306,10973,47586.0,0.285
31204,2018,87273,11232,38926,32672,6254,21630,11042,50838.65,0.284
31204,2019,88329,12097,39181,33477,5704,22325,11152,54216.65,0.285
31206,2010,20754,2449,9457,7925,1532,6156,1769,48767.5,0.187
31206,2011,21163,2226,9406,7814,1592,6078,1736,48984.5,0.185
31206,2012,22158,2479,9780,8123,1657,6233,1890,48976.25,0.193
31206,2013,22391,2451,9644,7949,1695,6067,1882,48349.5,0.195
31206,2014,21805,2422,9448,7629,1819,5803,1826,48528.5,0.193
31206,2015,22541,2489,9537,7841,1696,5794,2047,47563.75,0.215
31206,2016,22425,2740,9280,7833,1447,5654,2179,50458.75,0.235
31206,2017,22073,2876,9085,7776,1309,5519,2257,53021.25,0.248
31206,2018,22205,3032,9368,8014,1354,5584,2430,55727.25,0.259
31206,2019,22950,3110,9761,8640,1121,5985,2655,58432.25,0.272
31207,2010,27879,3523,11602,10000,1602,6419,3581,38585.6,0.309
31207,2011,27691,3832,11976,10105,1871,6744,3361,42704.6,0.281
31207,2012,28306,3600,12050,10209,1841,6864,3345,43425.2,0.278
31207,2013,27975,3591,11975,10049,1926,6605,3444,45382.8,0.288
31207,2014,27913,3640,12099,10091,2008,6627,3464,46628.6,0.286
31207,2015,27506,3551,12378,10217,2161,6598,3619,49890.4,0.292
31207,2016,27771,3548,12620,10486,2134,6591,3895,48385.8,0.309
31207,2017,28023,3598,12616,10326,2290,6696,3630,50177.4,0.288
31207,2018,27953,3601,12769,10520,2249,6948,3572,52812.2,0.28
31207,2019,28288,3820,12801,10713,2088,6926,3787,58984.2,0.296
31209,2010,2618,427,1534,1218,316,459,759,21597.0,0.495
31209,2011,2578,427,1501,1149,352,436,713,20750.0,0.475
31209,2012,2616,393,1529,1186,343,376,810,16941.0,0.53
31209,2013,2455,362,1529,1162,367,372,790,12475.0,0.517
31209,2014,2741,287,1553,1184,369,312,872,12333.0,0.561
31209,2015,2769,250,1582,1199,383,286,913,17558.0,0.577
31209,2016,2882,327,1572,1213,359,263,950,19841.0,0.604
31209,2017,2850,372,1574,1259,315,326,933,28902.0,0.593
31209,2018,3019,457,1629,1293,336,280,1013,23711.0,0.622
31209,2019,3311,565,1645,1383,262,293,1090,27188.0,0.663
31210,2010,5816,624,3470,2286,1184,557,1729,21117.5,0.498
31210,2011,5798,720,3408,2264,1144,500,1764,20848.5,0.518
31210,2012,5988,830,3424,2422,1002,436,1986,16595.5,0.58
31210,2013,5356,735,3596,2350,1246,427,1923,12765.5,0.535
31210,2014,5730,689,3772,2450,1322,383,2067,10834.0,0.548
31210,2015,5661,689,3607,2523,1084,365,2158,13779.0,0.598
31210,2016,5403,744,3532,2444,1088,382,2062,16954.5,0.584
31210,2017,5048,757,3474,2355,1119,451,1904,22494.5,0.548
31210,2018,5167,882,3312,2292,1020,423,1869,22422.5,0.564
31210,2019,5178,989,3096,2306,790,429,1877,29080.0,0.606
31211,2010,24476,4278,10632,8836,1796,6797,2039,53946.4,0.192
31211,2011,24394,4474,10933,8926,2007,6736,2190,53762.8,0.2
31211,2012,25071,4502,10926,9178,1748,6957,2221,52938.4,0.203
31211,2013,25199,4656,10751,9136,1615,6640,2496,52847.6,0.232
31211,2014,25712,5082,10852,9442,1410,6565,2877,53153.0,0.265
31211,2015,25970,5205,10915,9554,1361,6506,3048,53733.6,0.279
31211,2016,26065,5600,10861,9663,1198,6698,2965,55911.2,0.273
31211,2017,26789,5893,10817,9717,1100,6629,3088,57360.8,0.285
31211,2018,26348,5924,10656,9636,1020,6604,3032,58290.6,0.285
31211,2019,26561,6242,10609,9580,1029,6577,3003,63136.0,0.283
31213,2010,6240,667,2631,2202,429,841,1361,34167.0,0.517
31213,2011,6342,674,2970,2397,573,918,1479,29840.0,0.498
31213,2012,6437,696,3008,2412,596,1029,1383,33348.0,0.46
31213,2013,6535,807,3107,2394,713,906,1488,36435.0,0.479
31213,2014,6611,842,3108,2447,661,869,1578,37118.0,0.508
31213,2015,6649,892,3296,2587,709,939,1648,41670.0,0.5
31213,2016,6658,1101,3503,2729,774,942,1787,43326.0,0.51
31213,2017,6622,950,3245,2487,758,838,1649,44828.0,0.508
31213,2018,6581,1147,3303,2664,639,1095,1569,46875.0,0.475
31213,2019,6577,1152,3380,2780,600,985,1795,44881.0,0.531
31217,2010,5423,840,2817,2340,477,1617,723,44833.5,0.257
31217,2011,5611,962,2953,2416,537,1676,740,46982.5,0.251
31217,2012,5957,1128,3000,2501,499,1738,763,49482.0,0.254
31217,2013,5756,1206,2980,2485,495,1681,804,48327.5,0.27
31217,2014,5832,1216,3053,2541,512,1481,1060,48786.0,0.347
31217,2015,5955,1191,3151,2668,483,1543,1125,47248.5,0.357
31217,2016,5968,1161,3072,2676,396,1500,1176,49447.0,0.383
31217,2017,6000,1156,3116,2664,452,1487,1177,50924.0,0.378
31217,2018,6105,1181,3106,2648,458,1447,1201,51529.0,0.387
31217,2019,6248,1327,3090,2660,430,1449,1211,56226.0,0.392
31221,2010,6240,667,2631,2202,429,841,1361,34167.0,0.517
31221,2011,6342,674,2970,2397,573,918,1479,29840.0,0.498
31221,2012,6437,696,3008,2412,596,1029,1383,33348.0,0.46
31221,2013,6535,807,3107,2394,713,906,1488,36435.0,0.479
31221,2014,6611,842,3108,2447,661,869,1578,37118.0,0.508
31221,2015,6649,892,3296,2587,709,939,1648,41670.0,0.5
31221,2016,6658,1101,3503,2729,774,942,1787,43326.0,0.51
31221,2017,6622,950,3245,2487,758,838,1649,44828.0,0.508
31221,2018,6581,1147,3303,2664,639,1095,1569,46875.0,0.475
31221,2019,6577,1152,3380,2780,600,985,1795,44881.0,0.531
31301,2010,36615,6007,16110,13777,2333,10915,2862,58868.14,0.178
31301,2011,37139,5839,16078,13679,2399,10753,2926,59248.0,0.182
31301,2012,38736,6233,16502,14109,2393,11105,3004,59336.86,0.182
31301,2013,38433,6282,16253,13759,2494,10864,2895,59709.0,0.178
31301,2014,37941,6388,15975,13376,2599,10523,2853,60040.57,0.179
31301,2015,38468,6493,16045,13524,2521,10289,3235,59876.14,0.202
31301,2016,38621,6854,15884,13530,2354,10263,3267,62714.0,0.206
31301,2017,38861,7064,15707,13455,2252,10104,3351,66757.57,0.213
31301,2018,39205,7259,15937,13740,2197,10186,3554,69898.57,0.223
31301,2019,40117,7274,16306,14379,1927,10682,3697,72249.86,0.227
31304,2010,4389,578,1816,1666,150,1286,380,55574.0,0.209
31304,2011,4169,459,1786,1585,201,1257,328,56058.0,0.184
31304,2012,4151,578,1741,1538,203,1231,307,57625.0,0.176
31304,2013,4440,652,1785,1556,229,1286,270,60000.0,0.151
31304,2014,4215,555,1779,1565,214,1259,306,58467.0,0.172
31304,2015,4225,555,1829,1599,230,1281,318,51453.0,0.174
31304,2016,4484,621,1907,1708,199,1352,356,49079.0,0.187
31304,2017,4386,575,1922,1718,204,1358,360,46553.0,0.187
31304,2018,4555,629,1984,1779,205,1389,390,47819.0,0.197
31304,2019,4983,741,2070,1889,181,1534,355,57036.0,0.171
31305,2010,11166,1063,4953,4477,476,2520,1957,43327.5,0.395
31305,2011,10654,982,5020,4400,620,2586,1814,41822.5,0.361
31305,2012,11006,1368,4987,4430,557,2581,1849,45359.5,0.371
31305,2013,10855,1274,4920,4227,693,2486,1741,45263.5,0.354
31305,2014,10696,1040,4872,4092,780,2413,1679,45283.5,0.345
31305,2015,11159,1072,4716,4063,653,2267,1796,42525.5,0.381
31305,2016,11060,1123,4688,4145,543,2298,1847,43044.0,0.394
31305,2017,10944,997,4812,4217,595,2437,1780,41376.0,0.37
31305,2018,11128,1064,4844,4297,547,2429,1868,41787.0,0.386
31305,2019,11741,1231,4844,4374,470,2518,1856,45982.0,0.383
31309,2010,20754,2449,9457,7925,1532,6156,1769,48767.5,0.187
31309,2011,21163,2226,9406,7814,1592,6078,1736,48984.5,0.185
31309,2012,22158,2479,9780,8123,1657,6233,1890,48976.25,0.193
31309,2013,22391,2451,9644,7949,1695,6067,1882,48349.5,0.195
31309,2014,21805,2422,9448,7629,1819,5803,1826,48528.5,0.193
31309,2015,22541,2489,9537,7841,1696,5794,2047,47563.75,0.215
31309,2016,22425,2740,9280,7833,1447,5654,2179,50458.75,0.235
31309,2017,22073,2876,9085,7776,1309,5519,2257,53021.25,0.248
31309,2018,22205,3032,9368,8014,1354,5584,2430,55727.25,0.259
31309,2019,22950,3110,9761,8640,1121,5985,2655,58432.25,0.272
31310,2010,20754,2449,9457,7925,1532,6156,1769,48767.5,0.187
31310,2011,21163,2226,9406,7814,1592,6078,1736,48984.5,0.185
31310,2012,22158,2479,9780,8123,1657,6233,1890,48976.25,0.193
31310,2013,22391,2451,9644,7949,1695,6067,1882,48349.5,0.195
31310,2014,21805,2422,9448,7629,1819,5803,1826,48528.5,0.193
31310,2015,22541,2489,9537,7841,1696,5794,2047,47563.75,0.215
31310,2016,22425,2740,9280,7833,1447,5654,2179,50458.75,0.235
31310,2017,22073,2876,9085,7776,1309,5519,2257,53021.25,0.248
31310,2018,22205,3032,9368,8014,1354,5584,2430,55727.25,0.259
31310,2019,22950,3110,9761,8640,1121,5985,2655,58432.25,0.272
31313,2010,79877,16367,35616,30574,5042,23029,7545,65632.53,0.212
31313,2011,80765,16612,35982,30482,5500,23178,7304,67984.53,0.203
31313,2012,82455,16876,36607,31208,5399,23502,7706,63342.93,0.211
31313,2013,82525,17196,36273,30884,5389,23349,7535,63974.4,0.208
31313,2014,83007,18121,36373,30689,5684,23056,7633,64513.87,0.21
31313,2015,83474,18452,36690,31018,5672,23059,7959,65698.93,0.217
31313,2016,84447,19701,36647,31556,5091,23183,8373,67619.07,0.228
31313,2017,85669,20886,36852,31728,5124,23250,8478,70835.87,0.23
31313,2018,85127,20774,37293,32091,5202,23376,8715,74047.07,0.234
31313,2019,86371,20850,37940,32881,5059,24143,8738,77484.27,0.23
31316,2010,33605,5344,15008,12463,2545,9468,2995,69386.33,0.2
31316,2011,34210,5778,15332,12538,2794,9655,2883,70452.33,0.188
31316,2012,34541,5905,15511,12860,2651,10056,2804,63846.67,0.181
31316,2013,34930,6239,15628,12979,2649,10297,2682,63825.5,0.172
31316,2014,35607,6733,15826,13112,2714,10369,2743,64590.67,0.173
31316,2015,35925,7125,15922,13269,2653,10375,2894,65505.67,0.182
31316,2016,36242,7632,15925,13402,2523,10483,2919,68716.0,0.183
31316,2017,37325,8134,16152,13573,2579,10518,3055,69094.67,0.189
31316,2018,36660,7934,16094,13507,2587,10513,2994,72585.5,0.186
31316,2019,37172,7934,16278,13739,2539,10865,2874,75053.83,0.177
31319,2010,4389,578,1816,1666,150,1286,380,55574.0,0.209
31319,2011,4169,459,1786,1585,201,1257,328,56058.0,0.184
31319,2012,4151,578,1741,1538,203,1231,307,57625.0,0.176
31319,2013,4440,652,1785,1556,229,1286,270,60000.0,0.151
31319,2014,4215,555,1779,1565,214,1259,306,58467.0,0.172
31319,2015,4225,555,1829,1599,230,1281,318,51453.0,0.174
31319,2016,4484,621,1907,1708,199,1352,356,49079.0,0.187
31319,2017,4386,575,1922,1718,204,1358,360,46553.0,0.187
31319,2018,4555,629,1984,1779,205,1389,390,47819.0,0.197
31319,2019,4983,741,2070,1889,181,1534,355,57036.0,0.171
31320,2010,20754,2449,9457,7925,1532,6156,1769,48767.5,0.187
31320,2011,21163,2226,9406,7814,1592,6078,1736,48984.5,0.185
31320,2012,22158,2479,9780,8123,1657,6233,1890,48976.25,0.193
31320,2013,22391,2451,9644,7949,1695,6067,1882,48349.5,0.195
31320,2014,21805,2422,9448,7629,1819,5803,1826,48528.5,0.193
31320,2015,22541,2489,9537,7841,1696,5794,2047,47563.75,0.215
31320,2016,22425,2740,9280,7833,1447,5654,2179,50458.75,0.235
31320,2017,22073,2876,9085,7776,1309,5519,2257,53021.25,0.248
31320,2018,22205,3032,9368,8014,1354,5584,2430,55727.25,0.259
31320,2019,22950,3110,9761,8640,1121,5985,2655,58432.25,0.272
31322,2010,3005,324,1969,1343,626,286,1057,24375.0,0.537
31322,2011,2988,315,1832,1313,519,265,1048,26318.0,0.572
31322,2012,2854,231,1635,1150,485,185,965,24844.0,0.59
31322,2013,3490,210,1629,1212,417,213,999,24873.0,0.613
31322,2014,3916,154,1508,1255,253,194,1061,26830.0,0.704
31322,2015,3809,211,1596,1356,240,220,1136,24828.0,0.712
31322,2016,4079,315,1702,1402,300,240,1162,25370.0,0.683
31322,2017,4213,308,1671,1437,234,221,1216,29066.0,0.728
31322,2018,4532,377,1883,1642,241,272,1370,29491.0,0.728
31322,2019,4298,395,1844,1517,327,268,1249,34830.0,0.677
31323,2010,8139,791,3123,2980,143,2730,250,60900.0,0.08
31323,2011,8533,945,3266,3136,130,2778,358,57010.0,0.11
31323,2012,8639,1066,3196,3081,115,2707,374,62665.0,0.117
31323,2013,9089,1133,3341,3213,128,2789,424,58635.0,0.127
31323,2014,8841,1170,3402,3305,97,2765,540,59117.0,0.159
31323,2015,8872,1306,3341,3258,83,2813,445,63824.0,0.133
31323,2016,8976,1555,3381,3292,89,2766,526,62038.0,0.156
31323,2017,9164,1656,3381,3287,94,2808,479,62065.0,0.142
31323,2018,9446,1779,3438,3332,106,2820,512,66200.0,0.149
31323,2019,9214,1852,3510,3357,153,2920,437,76528.0,0.125
31327,2010,4389,578,1816,1666,150,1286,380,55574.0,0.209
31327,2011,4169,459,1786,1585,201,1257,328,56058.0,0.184
31327,2012,4151,578,1741,1538,203,1231,307,57625.0,0.176
31327,2013,4440,652,1785,1556,229,1286,270,60000.0,0.151
31327,2014,4215,555,1779,1565,214,1259,306,58467.0,0.172
31327,2015,4225,555,1829,1599,230,1281,318,51453.0,0.174
31327,2016,4484,621,1907,1708,199,1352,356,49079.0,0.187
31327,2017,4386,575,1922,1718,204,1358,360,46553.0,0.187
31327,2018,4555,629,1984,1779,205,1389,390,47819.0,0.197
31327,2019,4983,741,2070,1889,181,1534,355,57036.0,0.171
31331,2010,19305,1854,8076,7457,619,5250,2207,49185.0,0.273
31331,2011,19187,1927,8286,7536,750,5364,2172,46885.0,0.262
31331,2012,19645,2434,8183,7511,672,5288,2223,51128.0,0.272
31331,2013,19944,2407,8261,7440,821,5275,2165,49720.67,0.262
31331,2014,19537,2210,8274,7397,877,5178,2219,49894.67,0.268
31331,2015,20031,2378,8057,7321,736,5080,2241,49625.0,0.278
31331,2016,20036,2678,8069,7437,632,5064,2373,49375.33,0.294
31331,2017,20108,2653,8193,7504,689,5245,2259,48272.33,0.276
31331,2018,20574,2843,8282,7629,653,5249,2380,49924.67,0.287
31331,2019,20955,3083,8354,7731,623,5438,2293,56164.0,0.274
31333,2010,3609,1551,2209,1864,345,615,1249,53947.0,0.565
31333,2011,3729,1422,2180,1917,263,664,1253,51174.0,0.575
31333,2012,3661,1284,2297,2024,273,568,1456,43670.0,0.634
31333,2013,3868,1321,2212,2018,194,580,1438,45629.0,0.65
31333,2014,4285,1768,2289,2117,172,538,1579,48583.0,0.69
31333,2015,4193,1677,2368,2172,196,549,1623,51333.0,0.685
31333,2016,4486,1851,2497,2309,188,553,1756,51335.0,0.703
31333,2017,4695,2190,2515,2322,193,557,1765,56897.0,0.702
31333,2018,4308,2240,2609,2227,382,440,1787,66949.0,0.685
31333,2019,4029,2031,2587,2043,544,538,1505,72022.0,0.582
31401,2010,16629,7793,10186,8193,1993,4022,4171,58072.2,0.409
31401,2011,16329,8168,10081,8067,2014,4060,4007,63490.0,0.397
31401,2012,15945,7982,9906,8145,1761,4044,4101,63129.6,0.414
31401,2013,15604,7836,9811,8025,1786,4020,4005,65002.2,0.408
31401,2014,16296,8231,10045,8393,1652,4204,4189,64847.6,0.417
31401,2015,17275,8636,10267,8823,1444,4039,4784,69799.4,0.466
31401,2016,17523,8504,10363,8756,1607,4050,4706,69684.6,0.454
31401,2017,18593,9092,10549,8821,1728,4355,4466,77943.8,0.423
31401,2018,18604,9590,10844,9018,1826,4497,4521,82557.2,0.417
31401,2019,19301,10448,11294,9390,1904,4464,4926,89308.2,0.436
31402,2010,4433,2536,2210,2023,187,1688,335,114922.0,0.152
31402,2011,4327,2521,2117,1896,221,1539,357,125792.0,0.169
31402,2012,4225,2347,2055,1848,207,1479,369,123676.0,0.18
31402,2013,4319,2336,2017,1877,140,1544,333,125819.0,0.165
31402,2014,4469,2394,2006,1807,199,1504,303,128578.0,0.151
31402,2015,4650,2647,2044,1847,197,1521,326,139487.0,0.159
31402,2016,4781,2633,2045,1856,189,1509,347,138276.0,0.17
31402,2017,5183,2898,2098,1969,129,1574,395,149450.0,0.188
31402,2018,5373,2967,2151,1997,154,1534,463,154911.0,0.215
31402,2019,5410,3142,2140,2084,56,1572,512,168396.0,0.239
31403,2010,728,36,760,425,335,41,384,15585.0,0.505
31403,2011,952,38,856,590,266,52,538,16201.0,0.629
31403,2012,1379,123,1003,715,288,58,657,18638.0,0.655
31403,2013,1829,175,1139,863,276,23,840,18778.0,0.737
31403,2014,2036,222,1228,911,317,26,885,18359.0,0.721
31403,2015,2509,235,1247,1011,236,23,988,18750.0,0.792
31403,2016,2817,276,1315,1080,235,30,1050,19754.0,0.798
31403,2017,2516,235,1348,1126,222,46,1080,18030.0,0.801
31403,2018,2654,218,1360,1137,223,28,1109,20146.0,0.815
31403,2019,3368,155,1435,1304,131,39,1265,23587.0,0.882
31404,2010,14621,4575,6676,5232,1444,2486,2746,41109.4,0.411
31404,2011,13404,4709,6592,5256,1336,2486,2770,41390.0,0.42
31404,2012,12978,5024,6304,5330,974,2579,2751,51756.0,0.436
31404,2013,12777,4966,6348,5212,1136,2492,2720,50454.75,0.428
31404,2014,13317,5194,6587,5596,991,2716,2880,52838.5,0.437
31404,2015,14033,5399,6838,5944,894,2586,3358,47034.6,0.491
31404,2016,14039,5672,6930,5901,1029,2577,3324,52212.2,0.48
31404,2017,14548,5995,7229,5871,1358,2738,3133,57872.6,0.433
31404,2018,14780,6323,7664,6025,1639,2826,3199,59733.8,0.417
31404,2019,15711,7066,8329,6548,1781,2947,3601,67095.6,0.432
31405,2010,12012,3184,7851,5426,2425,1763,3663,33352.0,0.467
31405,2011,12236,3457,8004,5679,2325,1693,3986,33684.14,0.498
31405,2012,12999,3858,8170,5749,2421,1838,3911,37614.14,0.479
31405,2013,14673,4025,8425,6166,2259,1780,4386,36057.29,0.521
31405,2014,16357,4687,8614,6638,1976,1782,4856,38274.29,0.564
31405,2015,18065,4684,8578,6886,1692,1714,5172,37987.43,0.603
31405,2016,19238,4653,8681,7116,1565,1754,5362,38446.29,0.618
31405,2017,19568,4974,8983,7379,1604,1784,5595,40513.0,0.623
31405,2018,20057,5196,9148,7403,1745,1822,5581,45166.14,0.61
31405,2019,20440,5202,9252,7557,1695,1991,5566,48304.43,0.602
31406,2010,24473,1895,9318,7345,1973,4713,2632,35453.88,0.282
31406,2011,24151,2112,9513,7461,2052,4882,2579,35352.75,0.271
31406,2012,24658,2264,9660,7813,1847,5107,2706,36252.25,0.28
31406,2013,25397,2413,9600,7686,1914,5104,2582,36521.0,0.269
31406,2014,26145,2478,9713,7677,2036,5099,2578,37016.38,0.265
31406,2015,26791,2491,9760,7805,1955,5134,2671,37847.5,0.274
31406,2016,27678,2515,9799,8012,1787,5216,2796,40035.0,0.285
31406,2017,27559,2460,9980,7975,2005,4951,3024,42941.12,0.303
31406,2018,27498,2562,9919,8047,1872,5137,2910,44646.0,0.293
31406,2019,27122,2896,9964,8216,1748,5336,2880,46780.12,0.289
31407,2010,3696,696,1845,1455,390,621,834,29940.0,0.452
31407,2011,3706,615,1774,1483,291,546,937,31140.0,0.528
31407,2012,3441,474,1664,1286,378,437,849,32577.0,0.51
31407,2013,3250,589,1620,1265,355,541,724,33139.0,0.447
31407,2014,3127,645,1614,1262,352,483,779,31471.0,0.483
31407,2015,3587,673,1683,1359,324,497,862,31469.0,0.512
31407,2016,3516,745,1786,1423,363,551,872,32288.0,0.488
31407,2017,3603,834,1806,1540,266,631,909,29786.0,0.503
31407,2018,3824,940,1843,1586,257,624,962,31891.0,0.522
31407,2019,3998,780,1823,1581,242,610,971,34508.0,0.533
31408,2010,6701,1020,3814,2798,1016,907,1891,27157.5,0.496
31408,2011,6694,930,3606,2796,810,811,1985,28729.0,0.55
31408,2012,6295,705,3299,2436,863,622,1814,28710.5,0.55
31408,2013,6740,799,3249,2477,772,754,1723,29006.0,0.53
31408,2014,7043,799,3122,2517,605,677,1840,29150.5,0.589
31408,2015,7396,884,3279,2715,564,717,1998,28148.5,0.609
31408,2016,7595,1060,3488,2825,663,791,2034,28829.0,0.583
31408,2017,7816,1142,3477,2977,500,852,2125,29426.0,0.611
31408,2018,8356,1317,3726,3228,498,896,2332,30691.0,0.626
31408,2019,8296,1175,3667,3098,569,878,2220,34669.0,0.605
31409,2010,2889,288,717,613,104,155,458,28792.0,0.639
31409,2011,2490,298,702,540,162,128,412,27875.0,0.587
31409,2012,2351,267,685,487,198,130,357,32566.0,0.521
31409,2013,2483,246,654,479,175,110,369,31607.0,0.564
31409,2014,2646,245,679,537,142,117,420,30272.0,0.619
31409,2015,2774,255,713,599,114,105,494,29238.0,0.693
31409,2016,2996,214,732,671,61,127,544,28016.0,0.743
31409,2017,3060,247,741,699,42,137,562,28287.0,0.758
31409,2018,3133,266,760,699,61,168,531,35483.0,0.699
31409,2019,2846,259,651,606,45,198,408,36750.0,0.627
31415,2010,6116,2596,3562,2696,866,1883,813,67636.0,0.228
31415,2011,5845,2624,3419,2577,842,1725,852,72660.5,0.249
31415,2012,5366,2470,3327,2401,926,1666,735,69855.0,0.221
31415,2013,5491,2447,3241,2374,867,1687,687,72829.5,0.212
31415,2014,5732,2498,3175,2315,860,1643,672,75032.0,0.212
31415,2015,5894,2749,3207,2347,860,1643,704,81287.5,0.22
31415,2016,6181,2723,3162,2351,811,1645,706,82534.5,0.223
31415,2017,6683,3005,3265,2503,762,1721,782,88562.0,0.24
31415,2018,6832,3074,3349,2557,792,1668,889,90808.0,0.265
31415,2019,6678,3269,3320,2609,711,1690,919,97539.5,0.277
31418,2010,3696,696,1845,1455,390,621,834,29940.0,0.452
31418,2011,3706,615,1774,1483,291,546,937,31140.0,0.528
31418,2012,3441,474,1664,1286,378,437,849,32577.0,0.51
31418,2013,3250,589,1620,1265,355,541,724,33139.0,0.447
31418,2014,3127,645,1614,1262,352,483,779,31471.0,0.483
31418,2015,3587,673,1683,1359,324,497,862,31469.0,0.512
31418,2016,3516,745,1786,1423,363,551,872,32288.0,0.488
31418,2017,3603,834,1806,1540,266,631,909,29786.0,0.503
31418,2018,3824,940,1843,1586,257,624,962,31891.0,0.522
31418,2019,3998,780,1823,1581,242,610,971,34508.0,0.533
31419,2010,2889,288,717,613,104,155,458,28792.0,0.639
31419,2011,2490,298,702,540,162,128,412,27875.0,0.587
31419,2012,2351,267,685,487,198,130,357,32566.0,0.521
31419,2013,2483,246,654,479,175,110,369,31607.0,0.564
31419,2014,2646,245,679,537,142,117,420,30272.0,0.619
31419,2015,2774,255,713,599,114,105,494,29238.0,0.693
31419,2016,2996,214,732,671,61,127,544,28016.0,0.743
31419,2017,3060,247,741,699,42,137,562,28287.0,0.758
31419,2018,3133,266,760,699,61,168,531,35483.0,0.699
31419,2019,2846,259,651,606,45,198,408,36750.0,0.627
31503,2010,15082,1564,5302,4534,768,3932,602,55033.0,0.114
31503,2011,15568,1392,5114,4508,606,3916,592,58097.0,0.116
31503,2012,15606,1628,5218,4562,656,3826,736,59327.0,0.141
31503,2013,14620,1594,5208,4556,652,3954,602,58203.0,0.116
31503,2014,13852,1394,4982,4470,512,3634,836,52120.0,0.168
31503,2015,13280,1626,4972,4526,446,3508,1018,60430.0,0.205
31503,2016,13428,1370,5076,4568,508,3484,1084,60550.0,0.214
31503,2017,14334,1174,5286,4738,548,3834,904,59639.0,0.171
31503,2018,12786,924,5000,4314,686,3488,826,63701.0,0.165
31503,2019,12904,988,5078,4426,652,3694,732,65576.0,0.144
31510,2010,58340,5642,24044,20216,3828,16038,4178,49080.5,0.174
31510,2011,59468,6111,24050,20127,3923,15910,4217,50277.25,0.175
31510,2012,60727,6738,24623,20857,3766,16092,4765,51505.0,0.194
31510,2013,60709,7165,24672,21162,3510,16241,4921,51289.0,0.199
31510,2014,59623,7333,24555,20778,3777,15752,5026,50832.5,0.205
31510,2015,59366,7776,24721,20890,3831,15468,5422,53846.62,0.219
31510,2016,59089,8053,24915,21264,3651,15484,5780,53789.38,0.232
31510,2017,59767,8452,25350,21435,3915,16127,5308,55060.5,0.209
31510,2018,59121,8269,25551,21301,4250,16274,5027,59118.5,0.197
31510,2019,59881,8504,25854,21834,4020,16883,4951,61059.5,0.191
31512,2010,15817,1526,6075,5368,707,4202,1166,46667.0,0.192
31512,2011,15993,1919,6289,5573,716,4363,1210,47577.75,0.192
31512,2012,15723,1794,6323,5565,758,4397,1168,45782.75,0.185
31512,2013,15715,1779,6397,5744,653,4529,1215,45100.5,0.19
31512,2014,15800,1733,6360,5754,606,4524,1230,44910.0,0.193
31512,2015,15567,1662,6328,5708,620,4523,1185,45964.5,0.187
31512,2016,15624,1347,6312,5700,612,4518,1182,43475.0,0.187
31512,2017,15876,1453,6365,5796,569,4512,1284,49000.25,0.202
31512,2018,16585,1538,6529,5914,615,4662,1252,53260.75,0.192
31512,2019,16335,1702,6496,5822,674,4678,1144,58714.75,0.176
31516,2010,18452,1581,6847,5945,902,4835,1110,48773.5,0.162
31516,2011,18633,1571,6710,5955,755,4701,1254,50196.0,0.187
31516,2012,19760,1732,7100,6302,798,4816,1486,52207.5,0.209
31516,2013,19465,1730,7033,6282,751,4855,1427,51554.0,0.203
31516,2014,18717,1546,6787,6115,672,4475,1640,49016.5,0.242
31516,2015,18391,1523,6802,6163,639,4247,1916,52556.0,0.282
31516,2016,18056,1405,6937,6317,620,4053,2264,51865.5,0.326
31516,2017,17818,1345,6934,6342,592,4374,1968,51279.0,0.284
31516,2018,17781,1433,7057,6313,744,4363,1950,55250.0,0.276
31516,2019,17551,1426,6939,6244,695,4474,1770,57553.5,0.255
31518,2010,28317,2372,12305,10249,2056,7682,2567,43164.5,0.209
31518,2011,28947,2829,12519,10350,2169,7817,2533,44713.0,0.202
31518,2012,30088,3106,12897,10859,2038,8179,2680,46169.0,0.208
31518,2013,31253,3439,12998,11094,1904,8409,2685,46557.0,0.207
31518,2014,31076,3566,13133,11055,2078,8237,2818,46926.0,0.215
31518,2015,31385,3599,13247,11174,2073,8201,2973,47332.75,0.224
31518,2016,30765,3869,13185,11328,1857,7931,3397,45457.75,0.258
31518,2017,30383,4150,13273,11365,1908,8031,3334,47073.75,0.251
31518,2018,30506,4105,13548,11483,2065,8172,3311,49453.0,0.244
31518,2019,30889,4059,13576,11632,1944,8448,3184,51833.5,0.235
31519,2010,47517,4609,19400,16650,2750,12896,3754,45382.09,0.194
31519,2011,48650,5116,19653,16953,2700,13325,3628,46772.0,0.185
31519,2012,48979,5076,20021,17367,2654,13635,3732,47214.91,0.186
31519,2013,48802,5304,20074,17526,2548,13893,3633,47450.73,0.181
31519,2014,48750,5248,20067,17449,2618,13734,3715,47999.18,0.185
31519,2015,48422,5070,20017,17450,2567,13558,3892,49875.36,0.194
31519,2016,48679,4643,20156,17628,2528,13669,3959,49430.45,0.196
31519,2017,48853,4622,20453,17746,2707,13631,4115,52311.55,0.201
31519,2018,48648,4501,20454,17662,2792,13658,4004,54806.18,0.196
31519,2019,48977,5176,20656,17916,2740,14049,3867,59058.73,0.187
31520,2010,8928,1647,2272,1736,536,466,1270,42178.5,0.559
31520,2011,9117,2159,2819,2214,605,645,1569,54434.5,0.557
31520,2012,9595,1930,3037,2397,640,652,1745,52489.0,0.575
31520,2013,9101,1986,3117,2458,659,592,1866,53582.0,0.599
31520,2014,9333,2068,3226,2520,706,602,1918,56621.5,0.595
31520,2015,8840,1860,3232,2468,764,516,1952,57406.5,0.604
31520,2016,9203,2281,3230,2456,774,558,1898,57138.0,0.588
31520,2017,9471,2871,3464,2731,733,678,2053,61091.5,0.593
31520,2018,11060,3243,3709,3082,627,748,2334,64309.5,0.629
31520,2019,11291,3454,3888,3341,547,832,2509,68896.5,0.645
31522,2010,6141,3455,3103,2899,204,1783,1116,88021.0,0.36
31522,2011,5734,3437,3052,2733,319,1742,991,83406.0,0.325
31522,2012,5807,3316,2983,2711,272,1693,1018,88698.0,0.341
31522,2013,6081,3531,2986,2779,207,1811,968,94125.0,0.324
31522,2014,6101,3582,2983,2754,229,1885,869,101100.0,0.291
31522,2015,6278,3846,3015,2925,90,2032,893,100985.0,0.296
31522,2016,6275,3883,2985,2897,88,1977,920,106045.0,0.308
31522,2017,6282,3819,2871,2777,94,1945,832,116094.0,0.29
31522,2018,6291,3880,2835,2726,109,1863,863,128171.0,0.304
31522,2019,6175,3840,2806,2696,110,1941,755,158011.0,0.269
31523,2010,8928,1647,2272,1736,536,466,1270,42178.5,0.559
31523,2011,9117,2159,2819,2214,605,645,1569,54434.5,0.557
31523,2012,9595,1930,3037,2397,640,652,1745,52489.0,0.575
31523,2013,9101,1986,3117,2458,659,592,1866,53582.0,0.599
31523,2014,9333,2068,3226,2520,706,602,1918,56621.5,0.595
31523,2015,8840,1860,3232,2468,764,516,1952,57406.5,0.604
31523,2016,9203,2281,3230,2456,774,558,1898,57138.0,0.588
31523,2017,9471,2871,3464,2731,733,678,2053,61091.5,0.593
31523,2018,11060,3243,3709,3082,627,748,2334,64309.5,0.629
31523,2019,11291,3454,3888,3341,547,832,2509,68896.5,0.645
31525,2010,8928,1647,2272,1736,536,466,1270,42178.5,0.559
31525,2011,9117,2159,2819,2214,605,645,1569,54434.5,0.557
31525,2012,9595,1930,3037,2397,640,652,1745,52489.0,0.575
31525,2013,9101,1986,3117,2458,659,592,1866,53582.0,0.599
31525,2014,9333,2068,3226,2520,706,602,1918,56621.5,0.595
31525,2015,8840,1860,3232,2468,764,516,1952,57406.5,0.604
31525,2016,9203,2281,3230,2456,774,558,1898,57138.0,0.588
31525,2017,9471,2871,3464,2731,733,678,2053,61091.5,0.593
31525,2018,11060,3243,3709,3082,627,748,2334,64309.5,0.629
31525,2019,11291,3454,3888,3341,547,832,2509,68896.5,0.645
31532,2010,22061,2039,8908,7589,1319,6076,1513,48005.6,0.17
31532,2011,23009,1987,9012,7738,1274,6188,1550,48686.0,0.172
31532,2012,23260,2218,9251,8112,1139,6410,1702,50675.8,0.184
31532,2013,23112,2440,9219,8064,1155,6524,1540,50930.4,0.167
31532,2014,23113,2394,9167,7931,1236,6373,1558,50095.8,0.17
31532,2015,22939,2363,9130,7969,1161,6319,1650,52412.2,0.181
31532,2016,22988,2344,9187,8086,1101,6364,1722,54091.0,0.187
31532,2017,22926,2192,9343,8075,1268,6268,1807,55607.6,0.193
31532,2018,22134,2023,9114,7885,1229,6138,1747,57350.4,0.192
31532,2019,22141,2271,9268,8096,1172,6320,1776,59046.8,0.192
31533,2010,56913,6562,24685,21045,3640,15844,5201,44902.17,0.211
31533,2011,57737,6675,24867,21006,3861,16134,4872,47079.5,0.196
31533,2012,59484,6787,25464,21751,3713,16565,5186,47811.25,0.204
31533,2013,59633,6878,25127,21390,3737,16313,5077,48360.5,0.202
31533,2014,59294,6917,25115,20969,4146,16117,4852,49041.5,0.193
31533,2015,59697,6698,25263,21177,4086,16018,5159,49972.33,0.204
31533,2016,59812,6846,25046,21392,3654,15925,5467,50861.92,0.218
31533,2017,59233,7129,25156,21321,3835,15728,5593,53045.25,0.222
31533,2018,59318,7047,25448,21598,3850,15831,5767,55262.17,0.227
31533,2019,60350,7555,25911,22456,3455,16399,6057,59452.25,0.234
31535,2010,9639,1044,4417,3693,724,2618,1075,36253.5,0.243
31535,2011,9648,1210,4352,3642,710,2774,868,40375.5,0.199
31535,2012,9996,1064,4447,3690,757,2828,862,41427.0,0.194
31535,2013,9975,1085,4458,3718,740,2840,878,43452.0,0.197
31535,2014,9837,1121,4540,3764,776,2837,927,48936.0,0.204
31535,2015,9916,1045,4559,3773,786,2716,1057,51355.0,0.232
31535,2016,10067,952,4657,3842,815,2787,1055,49690.0,0.227
31535,2017,10051,977,4745,3875,870,2851,1024,50694.0,0.216
31535,2018,9929,940,4811,3863,948,2858,1005,51536.5,0.209
31535,2019,10501,1203,4892,3998,894,3051,947,59776.5,0.194
31537,2010,56503,5095,22688,19645,3043,15204,4441,46160.09,0.196
31537,2011,57339,5557,22862,19976,2886,15397,4579,46924.27,0.2
31537,2012,58366,5735,23385,20541,2844,15615,4926,47460.64,0.211
31537,2013,58735,6089,23429,20795,2634,15904,4891,47379.64,0.209
31537,2014,58667,5982,23127,20609,2518,15508,5101,47353.0,0.221
31537,2015,57994,5649,23004,20465,2539,15225,5240,48444.09,0.228
31537,2016,57652,5262,23127,20705,2422,15117,5588,48398.18,0.242
31537,2017,57214,5249,23267,20672,2595,15206,5466,51830.91,0.235
31537,2018,57792,5316,23359,20722,2637,15329,5393,54884.55,0.231
31537,2019,57497,5848,23530,20917,2613,15627,5290,57475.73,0.225
31539,2010,35858,3154,14956,12516,2440,9648,2868,45538.2,0.192
31539,2011,36731,3525,15076,12604,2472,9775,2829,47389.8,0.188
31539,2012,37891,3920,15506,13140,2366,10092,3048,48800.6,0.197
31539,2013,38563,4236,15602,13372,2230,10386,2986,48886.2,0.191
31539,2014,38002,4263,15624,13290,2334,10054,3236,47964.8,0.207
31539,2015,38025,4412,15733,13437,2296,9955,3482,49952.2,0.221
31539,2016,37479,4554,15723,13612,2111,9673,3939,48476.2,0.251
31539,2017,37550,4737,15916,13734,2182,9948,3786,49586.8,0.238
31539,2018,36899,4567,16048,13640,2408,9916,3724,52302.6,0.232
31539,2019,37341,4553,16115,13845,2270,10295,3550,54582.0,0.22
31542,2010,7541,782,2651,2267,384,1966,301,55033.0,0.114
31542,2011,7784,696,2557,2254,303,1958,296,58097.0,0.116
31542,2012,7803,814,2609,2281,328,1913,368,59327.0,0.141
31542,2013,7310,797,2604,2278,326,1977,301,58203.0,0.116
31542,2014,6926,697,2491,2235,256,1817,418,52120.0,0.168
31542,2015,6640,813,2486,2263,223,1754,509,60430.0,0.205
31542,2016,6714,685,2538,2284,254,1742,542,60550.0,0.214
31542,2017,7167,587,2643,2369,274,1917,452,59639.0,0.171
31542,2018,6393,462,2500,2157,343,1744,413,63701.0,0.165
31542,2019,6452,494,2539,2213,326,1847,366,65576.0,0.144
31543,2010,14130,1047,5713,4866,847,3635,1231,41072.0,0.215
31543,2011,13821,1075,5684,4824,860,3497,1327,41545.0,0.233
31543,2012,14994,1126,6091,5219,872,3770,1449,42391.5,0.238
31543,2013,15398,1225,6031,5263,768,3745,1518,42133.5,0.252
31543,2014,15123,1244,5859,5122,737,3483,1639,43154.0,0.28
31543,2015,15290,1131,5851,5142,709,3369,1773,42231.5,0.303
31543,2016,14983,1225,5900,5322,578,3205,2117,40585.0,0.359
31543,2017,14701,1271,5840,5367,473,3351,2016,40783.5,0.345
31543,2018,15163,1446,6093,5521,572,3567,1954,42106.5,0.321
31543,2019,14910,1371,5907,5390,517,3540,1850,43753.5,0.313
31545,2010,45209,3553,20505,16978,3527,11722,5256,39242.11,0.256
31545,2011,45357,3954,20770,16885,3885,11719,5166,40551.67,0.249
31545,2012,45508,4376,20745,16972,3773,12184,4788,41134.44,0.231
31545,2013,46107,4603,20699,17003,3696,12195,4808,41447.11,0.232
31545,2014,46470,5210,20814,17138,3676,12204,4934,40230.44,0.237
31545,2015,46780,5345,20851,17085,3766,12057,5028,40965.67,0.241
31545,2016,46897,5666,20836,17183,3653,12133,5050,41218.22,0.242
31545,2017,47492,5898,21160,17313,3847,12051,5262,42057.0,0.249
31545,2018,47084,5559,21225,17584,3641,12211,5373,44274.22,0.253
31545,2019,47720,5213,21226,17651,3575,12534,5117,47413.78,0.241
31546,2010,8835,778,4319,3584,735,2305,1279,35584.0,0.296
31546,2011,8396,716,4321,3434,887,2129,1305,36204.0,0.302
31546,2012,8388,720,4230,3298,932,2167,1131,36040.5,0.267
31546,2013,8709,655,4135,3295,840,2034,1261,36435.0,0.305
31546,2014,8863,707,4132,3329,803,1989,1340,36669.0,0.324
31546,2015,9077,712,4177,3295,882,1974,1321,35272.0,0.316
31546,2016,9088,806,4225,3378,847,2043,1335,35395.5,0.316
31546,2017,9256,855,4298,3446,852,2101,1345,35808.5,0.313
31546,2018,8862,818,4332,3520,812,2152,1368,35068.0,0.316
31546,2019,8864,679,4170,3390,780,2206,1184,37057.5,0.284
31547,2010,13335,1740,6262,5148,1114,3239,1909,34149.0,0.305
31547,2011,13354,1825,6126,5125,1001,3320,1805,37297.0,0.295
31547,2012,13437,1538,6111,4976,1135,3265,1711,38477.0,0.28
31547,2013,13225,1674,6078,4983,1095,3381,1602,40014.33,0.264
31547,2014,12964,1766,6154,5026,1128,3320,1706,43114.33,0.277
31547,2015,13503,1718,6242,5132,1110,3213,1919,44726.33,0.307
31547,2016,13583,1697,6443,5265,1178,3338,1927,43889.33,0.299
31547,2017,13654,1811,6551,5415,1136,3482,1933,43724.67,0.295
31547,2018,13753,1880,6654,5449,1205,3482,1967,44988.0,0.296
31547,2019,14499,1983,6715,5579,1136,3661,1918,51353.67,0.286
31548,2010,39835,4936,16285,14416,1869,10993,3423,48533.0,0.21
31548,2011,41284,5478,16771,14887,1884,11253,3634,49097.57,0.217
31548,2012,42184,5907,17189,15342,1847,11595,3747,49652.0,0.218
31548,2013,42774,6187,17461,15510,1951,11532,3978,48717.71,0.228
31548,2014,43002,6392,17467,15469,1998,11558,3911,49434.14,0.224
31548,2015,43587,6774,17619,15486,2133,11603,3883,49429.29,0.22
31548,2016,44566,7575,17725,15628,2097,11551,4077,50997.71,0.23
31548,2017,45284,7429,18111,15745,2366,11276,4469,53640.71,0.247
31548,2018,45745,8001,17848,15840,2008,11815,4025,56424.57,0.226
31548,2019,48542,8942,18582,16835,1747,11950,4885,58020.29,0.263
31550,2010,17406,1573,8109,6571,1538,4813,1758,43381.33,0.217
31550,2011,18098,1954,8366,6649,1717,5074,1575,45519.0,0.188
31550,2012,18131,2188,8406,6838,1568,5276,1562,46529.33,0.186
31550,2013,19098,2506,8569,7090,1479,5531,1559,47107.67,0.182
31550,2014,19285,2717,8837,7175,1662,5579,1596,47263.67,0.181
31550,2015,19634,2889,8931,7274,1657,5708,1566,48216.33,0.175
31550,2016,19423,3149,8786,7295,1491,5620,1675,46216.67,0.191
31550,2017,19732,3392,8982,7392,1590,5574,1818,48458.67,0.202
31550,2018,19118,3134,8991,7327,1664,5553,1774,50337.67,0.197
31550,2019,19790,3127,9176,7601,1575,5821,1780,52601.0,0.194
31551,2010,28317,2372,12305,10249,2056,7682,2567,43164.5,0.209
31551,2011,28947,2829,12519,10350,2169,7817,2533,44713.0,0.202
31551,2012,30088,3106,12897,10859,2038,8179,2680,46169.0,0.208
31551,2013,31253,3439,12998,11094,1904,8409,2685,46557.0,0.207
31551,2014,31076,3566,13133,11055,2078,8237,2818,46926.0,0.215
31551,2015,31385,3599,13247,11174,2073,8201,2973,47332.75,0.224
31551,2016,30765,3869,13185,11328,1857,7931,3397,45457.75,0.258
31551,2017,30383,4150,13273,11365,1908,8031,3334,47073.75,0.251
31551,2018,30506,4105,13548,11483,2065,8172,3311,49453.0,0.244
31551,2019,30889,4059,13576,11632,1944,8448,3184,51833.5,0.235
31552,2010,19541,2594,7205,6372,833,4926,1446,47095.67,0.201
31552,2011,19485,2644,7211,6320,891,5010,1310,53676.33,0.182
31552,2012,19676,2654,7204,6388,816,4920,1468,53417.0,0.204
31552,2013,18775,2496,7014,6215,799,4836,1379,53926.0,0.197
31552,2014,18391,2374,6942,6115,827,4738,1377,50091.0,0.198
31552,2015,17581,2427,7009,6120,889,4697,1423,55167.33,0.203
31552,2016,17760,2180,6998,6199,799,4604,1595,53257.67,0.228
31552,2017,18517,2258,7269,6333,936,4924,1409,54770.0,0.194
31552,2018,17836,1976,7155,6150,1005,4739,1411,59271.33,0.197
31552,2019,17662,1959,7068,6148,920,4737,1411,65354.33,0.2
31553,2010,34269,3107,12922,11313,1609,9037,2276,47369.17,0.176
31553,2011,34626,3490,12999,11528,1471,9064,2464,48450.5,0.19
31553,2012,35483,3526,13423,11867,1556,9213,2654,47924.33,0.198
31553,2013,35180,3509,13430,12026,1404,9384,2642,47251.67,0.197
31553,2014,34517,3279,13147,11869,1278,8999,2870,46278.83,0.218
31553,2015,33958,3185,13130,11871,1259,8770,3101,48161.67,0.236
31553,2016,33680,2752,13249,12017,1232,8571,3446,46271.83,0.26
31553,2017,33694,2798,13299,12138,1161,8886,3252,49759.83,0.245
31553,2018,34366,2971,13586,12227,1359,9025,3202,53923.83,0.236
31553,2019,33886,3128,13435,12066,1369,9152,2914,58327.67,0.217
31554,2010,62215,7224,26705,22785,3920,17650,5135,48019.92,0.192
31554,2011,63042,7355,26932,22633,4299,17537,5096,49281.25,0.189
31554,2012,64521,7727,27525,23497,4028,17824,5673,49965.92,0.206
31554,2013,64494,7925,27135,23184,3951,17351,5833,50091.67,0.215
31554,2014,64152,8169,27015,22458,4557,17161,5297,50445.17,0.196
31554,2015,64482,8204,27206,22594,4612,17061,5533,51461.67,0.203
31554,2016,64641,8708,27043,22918,4125,17207,5711,53195.58,0.211
31554,2017,64232,9280,27202,22778,4424,17139,5639,55672.17,0.207
31554,2018,65218,9347,27640,23239,4401,17587,5652,58983.92,0.204
31554,2019,65937,9809,28219,24234,3985,18089,6145,61988.67,0.218
31555,2010,36374,2775,16186,13394,2792,9417,3977,40287.29,0.246
31555,2011,36961,3238,16449,13451,2998,9590,3861,41793.86,0.235
31555,2012,37120,3656,16515,13674,2841,10017,3657,42589.86,0.221
31555,2013,37398,3948,16564,13708,2856,10161,3547,42879.14,0.214
31555,2014,37607,4503,16682,13809,2873,10215,3594,41248.0,0.215
31555,2015,37703,4633,16674,13790,2884,10083,3707,42592.43,0.222
31555,2016,37809,4860,16611,13805,2806,10090,3715,42881.86,0.224
31555,2017,38236,5043,16862,13867,2995,9950,3917,43842.29,0.232
31555,2018,38222,4741,16893,14064,2829,10059,4005,46904.57,0.237
31555,2019,38856,4534,17056,14261,2795,10328,3933,50372.71,0.231
31557,2010,21822,1598,8392,7356,1036,5738,1618,42514.0,0.193
31557,2011,21698,1750,8306,7402,904,5486,1916,42295.0,0.231
31557,2012,23914,1836,8982,8042,940,5806,2236,45088.0,0.249
31557,2013,24310,1866,8858,8008,850,5756,2252,44905.0,0.254
31557,2014,23582,1698,8592,7760,832,5316,2444,45913.0,0.284
31557,2015,23502,1420,8632,7800,832,4986,2814,44682.0,0.326
31557,2016,22684,1440,8798,8066,732,4622,3444,43181.0,0.391
31557,2017,21302,1516,8582,7946,636,4914,3032,42919.0,0.353
31557,2018,22776,1942,9114,8312,802,5238,3074,46799.0,0.337
31557,2019,22198,1864,8800,8062,738,5254,2808,49531.0,0.319
31558,2010,13335,1740,6262,5148,1114,3239,1909,34149.0,0.305
31558,2011,13354,1825,6126,5125,1001,3320,1805,37297.0,0.295
31558,2012,13437,1538,6111,4976,1135,3265,1711,38477.0,0.28
31558,2013,13225,1674,6078,4983,1095,3381,1602,40014.33,0.264
31558,2014,12964,1766,6154,5026,1128,3320,1706,43114.33,0.277
31558,2015,13503,1718,6242,5132,1110,3213,1919,44726.33,0.307
31558,2016,13583,1697,6443,5265,1178,3338,1927,43889.33,0.299
31558,2017,13654,1811,6551,5415,1136,3482,1933,43724.67,0.295
31558,2018,13753,1880,6654,5449,1205,3482,1967,44988.0,0.296
31558,2019,14499,1983,6715,5579,1136,3661,1918,51353.67,0.286
31560,2010,17406,1573,8109,6571,1538,4813,1758,43381.33,0.217
31560,2011,18098,1954,8366,6649,1717,5074,1575,45519.0,0.188
31560,2012,18131,2188,8406,6838,1568,5276,1562,46529.33,0.186
31560,2013,19098,2506,8569,7090,1479,5531,1559,47107.67,0.182
31560,2014,19285,2717,8837,7175,1662,5579,1596,47263.67,0.181
31560,2015,19634,2889,8931,7274,1657,5708,1566,48216.33,0.175
31560,2016,19423,3149,8786,7295,1491,5620,1675,46216.67,0.191
31560,2017,19732,3392,8982,7392,1590,5574,1818,48458.67,0.202
31560,2018,19118,3134,8991,7327,1664,5553,1774,50337.67,0.197
31560,2019,19790,3127,9176,7601,1575,5821,1780,52601.0,0.194
31562,2010,14520,1257,6257,5322,935,4110,1212,46248.75,0.194
31562,2011,15225,1291,6455,5484,971,4230,1254,46333.25,0.194
31562,2012,15457,1404,6642,5831,811,4497,1334,48513.0,0.201
31562,2013,15802,1643,6615,5786,829,4547,1239,49112.25,0.187
31562,2014,16187,1697,6676,5696,980,4556,1140,49589.75,0.171
31562,2015,16299,1550,6644,5706,938,4565,1141,50407.75,0.172
31562,2016,16274,1659,6649,5802,847,4622,1180,52476.25,0.177
31562,2017,15759,1605,6700,5706,994,4351,1355,54599.75,0.202
31562,2018,15741,1561,6614,5728,886,4394,1334,55762.75,0.202
31562,2019,15689,1777,6729,5883,846,4473,1410,57414.5,0.21
31565,2010,15817,1526,6075,5368,707,4202,1166,46667.0,0.192
31565,2011,15993,1919,6289,5573,716,4363,1210,47577.75,0.192
31565,2012,15723,1794,6323,5565,758,4397,1168,45782.75,0.185
31565,2013,15715,1779,6397,5744,653,4529,1215,45100.5,0.19
31565,2014,15800,1733,6360,5754,606,4524,1230,44910.0,0.193
31565,2015,15567,1662,6328,5708,620,4523,1185,45964.5,0.187
31565,2016,15624,1347,6312,5700,612,4518,1182,43475.0,0.187
31565,2017,15876,1453,6365,5796,569,4512,1284,49000.25,0.202
31565,2018,16585,1538,6529,5914,615,4662,1252,53260.75,0.192
31565,2019,16335,1702,6496,5822,674,4678,1144,58714.75,0.176
31566,2010,15817,1526,6075,5368,707,4202,1166,46667.0,0.192
31566,2011,15993,1919,6289,5573,716,4363,1210,47577.75,0.192
31566,2012,15723,1794,6323,5565,758,4397,1168,45782.75,0.185
31566,2013,15715,1779,6397,5744,653,4529,1215,45100.5,0.19
31566,2014,15800,1733,6360,5754,606,4524,1230,44910.0,0.193
31566,2015,15567,1662,6328,5708,620,4523,1185,45964.5,0.187
31566,2016,15624,1347,6312,5700,612,4518,1182,43475.0,0.187
31566,2017,15876,1453,6365,5796,569,4512,1284,49000.25,0.202
31566,2018,16585,1538,6529,5914,615,4662,1252,53260.75,0.192
31566,2019,16335,1702,6496,5822,674,4678,1144,58714.75,0.176
31567,2010,26520,3069,10811,9427,1384,7070,2357,45208.17,0.218
31567,2011,26926,3239,11109,9550,1559,7282,2268,48044.17,0.204
31567,2012,27330,3244,11237,9938,1299,7504,2434,49162.67,0.217
31567,2013,27267,3342,11025,9723,1302,7406,2317,50004.0,0.21
31567,2014,27652,3374,11127,9576,1551,7477,2099,49418.67,0.189
31567,2015,27240,3164,11167,9563,1604,7508,2055,51117.17,0.184
31567,2016,27320,3154,11109,9717,1392,7484,2233,51521.33,0.201
31567,2017,27109,3276,11326,9670,1656,7358,2312,53845.0,0.204
31567,2018,27184,3075,11269,9721,1548,7389,2332,56194.0,0.207
31567,2019,26899,3242,11258,9818,1440,7363,2455,60024.17,0.218
31568,2010,15817,1526,6075,5368,707,4202,1166,46667.0,0.192
31568,2011,15993,1919,6289,5573,716,4363,1210,47577.75,0.192
31568,2012,15723,1794,6323,5565,758,4397,1168,45782.75,0.185
31568,2013,15715,1779,6397,5744,653,4529,1215,45100.5,0.19
31568,2014,15800,1733,6360,5754,606,4524,1230,44910.0,0.193
31568,2015,15567,1662,6328,5708,620,4523,1185,45964.5,0.187
31568,2016,15624,1347,6312,5700,612,4518,1182,43475.0,0.187
31568,2017,15876,1453,6365,5796,569,4512,1284,49000.25,0.202
31568,2018,16585,1538,6529,5914,615,4662,1252,53260.75,0.192
31568,2019,16335,1702,6496,5822,674,4678,1144,58714.75,0.176
31569,2010,22234,1988,9766,8332,1434,6167,2165,44709.2,0.222
31569,2011,22713,2067,9863,8448,1415,6333,2115,45092.8,0.214
31569,2012,22883,2209,9962,8674,1288,6402,2272,46904.2,0.228
31569,2013,23555,2580,9999,8769,1230,6520,2249,47533.2,0.225
31569,2014,24150,2703,9980,8740,1240,6509,2231,48642.0,0.224
31569,2015,24036,2464,9874,8594,1280,6455,2139,48783.0,0.217
31569,2016,23972,2510,9878,8688,1190,6546,2142,50949.8,0.217
31569,2017,23520,2451,9968,8534,1434,6320,2214,54316.2,0.222
31569,2018,23426,2345,9773,8495,1278,6304,2191,56037.4,0.224
31569,2019,23611,2720,10095,8851,1244,6475,2376,56453.4,0.235
31598,2010,5616,530,2802,2396,406,1539,857,31538.0,0.306
31598,2011,5424,516,2790,2311,479,1375,936,31613.0,0.335
31598,2012,5351,512,2630,2100,530,1300,800,32386.0,0.304
31598,2013,5466,363,2533,2036,497,1167,869,33508.0,0.343
31598,2014,5531,312,2569,2087,482,1164,923,32943.0,0.359
31598,2015,5538,291,2642,2053,589,1098,955,30763.0,0.361
31598,2016,5447,301,2724,2089,635,1149,940,32802.0,0.345
31598,2017,5206,342,2749,2052,697,1207,845,32969.0,0.307
31598,2018,5087,343,2796,2155,641,1204,951,32722.0,0.34
31598,2019,5053,240,2663,2031,632,1293,738,36139.0,0.277
31599,2010,5616,530,2802,2396,406,1539,857,31538.0,0.306
31599,2011,5424,516,2790,2311,479,1375,936,31613.0,0.335
31599,2012,5351,512,2630,2100,530,1300,800,32386.0,0.304
31599,2013,5466,363,2533,2036,497,1167,869,33508.0,0.343
31599,2014,5531,312,2569,2087,482,1164,923,32943.0,0.359
31599,2015,5538,291,2642,2053,589,1098,955,30763.0,0.361
31599,2016,5447,301,2724,2089,635,1149,940,32802.0,0.345
31599,2017,5206,342,2749,2052,697,1207,845,32969.0,0.307
31599,2018,5087,343,2796,2155,641,1204,951,32722.0,0.34
31599,2019,5053,240,2663,2031,632,1293,738,36139.0,0.277
31601,2010,29505,3223,13187,10543,2644,5829,4714,37764.0,0.357
31601,2011,28372,3613,13245,10405,2840,5908,4497,36934.33,0.34
31601,2012,27795,3468,13020,10189,2831,5841,4348,36039.17,0.334
31601,2013,27388,3318,12934,9924,3010,5572,4352,36267.83,0.336
31601,2014,26857,3163,12842,9893,2949,5463,4430,37772.33,0.345
31601,2015,26894,3233,13069,10218,2851,5483,4735,39978.67,0.362
31601,2016,27175,3734,13575,10548,3027,5799,4749,40977.17,0.35
31601,2017,27424,3742,13355,10374,2981,5878,4496,42973.5,0.337
31601,2018,27104,4010,13357,10549,2808,6038,4511,44328.17,0.338
31601,2019,27804,4224,13488,10684,2804,6143,4541,45819.5,0.337
31602,2010,57876,8139,24787,20983,3804,14745,6238,44802.4,0.252
31602,2011,57986,8919,24714,21079,3635,14878,6201,46089.5,0.251
31602,2012,58238,9049,24653,20847,3806,14594,6253,45184.7,0.254
31602,2013,57358,8917,24773,20846,3927,14456,6390,44019.3,0.258
31602,2014,56120,8838,24602,20833,3769,14279,6554,44510.5,0.266
31602,2015,56972,9479,24941,21162,3779,14269,6893,45912.3,0.276
31602,2016,58446,10376,25514,21554,3960,14503,7051,46922.9,0.276
31602,2017,60142,10384,26106,22029,4077,14937,7092,48402.8,0.272
31602,2018,60072,11085,25811,21898,3913,15165,6733,51551.4,0.261
31602,2019,63859,11951,26502,22829,3673,15413,7416,54339.1,0.28
31604,2010,3696,696,1845,1455,390,621,834,29940.0,0.452
31604,2011,3706,615,1774,1483,291,546,937,31140.0,0.528
31604,2012,3441,474,1664,1286,378,437,849,32577.0,0.51
31604,2013,3250,589,1620,1265,355,541,724,33139.0,0.447
31604,2014,3127,645,1614,1262,352,483,779,31471.0,0.483
31604,2015,3587,673,1683,1359,324,497,862,31469.0,0.512
31604,2016,3516,745,1786,1423,363,551,872,32288.0,0.488
31604,2017,3603,834,1806,1540,266,631,909,29786.0,0.503
31604,2018,3824,940,1843,1586,257,624,962,31891.0,0.522
31604,2019,3998,780,1823,1581,242,610,971,34508.0,0.533
31605,2010,21631,3422,8798,7628,1170,5325,2303,49181.67,0.262
31605,2011,22167,3997,9067,7831,1236,5403,2428,51034.33,0.268
31605,2012,22530,4264,9138,7937,1201,5590,2347,49719.67,0.257
31605,2013,22160,4005,9315,7921,1394,5329,2592,44604.33,0.278
31605,2014,21402,4026,9248,7830,1418,5362,2468,42953.33,0.267
31605,2015,22314,4701,9535,8114,1421,5502,2612,44298.0,0.274
31605,2016,23478,5502,9766,8278,1488,5422,2856,44668.67,0.292
31605,2017,24662,5487,10064,8508,1556,5378,3130,45679.0,0.311
31605,2018,24906,6193,10036,8669,1367,5897,2772,50090.33,0.276
31605,2019,27515,6627,10439,9285,1154,5915,3370,53306.33,0.323
31620,2010,18452,1581,6847,5945,902,4835,1110,48773.5,0.162
31620,2011,18633,1571,6710,5955,755,4701,1254,50196.0,0.187
31620,2012,19760,1732,7100,6302,798,4816,1486,52207.5,0.209
31620,2013,19465,1730,7033,6282,751,4855,1427,51554.0,0.203
31620,2014,18717,1546,6787,6115,672,4475,1640,49016.5,0.242
31620,2015,18391,1523,6802,6163,639,4247,1916,52556.0,0.282
31620,2016,18056,1405,6937,6317,620,4053,2264,51865.5,0.326
31620,2017,17818,1345,6934,6342,592,4374,1968,51279.0,0.284
31620,2018,17781,1433,7057,6313,744,4363,1950,55250.0,0.276
31620,2019,17551,1426,6939,6244,695,4474,1770,57553.5,0.255
31622,2010,36374,2775,16186,13394,2792,9417,3977,40287.29,0.246
31622,2011,36961,3238,16449,13451,2998,9590,3861,41793.86,0.235
31622,2012,37120,3656,16515,13674,2841,10017,3657,42589.86,0.221
31622,2013,37398,3948,16564,13708,2856,10161,3547,42879.14,0.214
31622,2014,37607,4503,16682,13809,2873,10215,3594,41248.0,0.215
31622,2015,37703,4633,16674,13790,2884,10083,3707,42592.43,0.222
31622,2016,37809,4860,16611,13805,2806,10090,3715,42881.86,0.224
31622,2017,38236,5043,16862,13867,2995,9950,3917,43842.29,0.232
31622,2018,38222,4741,16893,14064,2829,10059,4005,46904.57,0.237
31622,2019,38856,4534,17056,14261,2795,10328,3933,50372.71,0.231
31623,2010,17406,1573,8109,6571,1538,4813,1758,43381.33,0.217
31623,2011,18098,1954,8366,6649,1717,5074,1575,45519.0,0.188
31623,2012,18131,2188,8406,6838,1568,5276,1562,46529.33,0.186
31623,2013,19098,2506,8569,7090,1479,5531,1559,47107.67,0.182
31623,2014,19285,2717,8837,7175,1662,5579,1596,47263.67,0.181
31623,2015,19634,2889,8931,7274,1657,5708,1566,48216.33,0.175
31623,2016,19423,3149,8786,7295,1491,5620,1675,46216.67,0.191
31623,2017,19732,3392,8982,7392,1590,5574,1818,48458.67,0.202
31623,2018,19118,3134,8991,7327,1664,5553,1774,50337.67,0.197
31623,2019,19790,3127,9176,7601,1575,5821,1780,52601.0,0.194
31624,2010,18452,1581,6847,5945,902,4835,1110,48773.5,0.162
31624,2011,18633,1571,6710,5955,755,4701,1254,50196.0,0.187
31624,2012,19760,1732,7100,6302,798,4816,1486,52207.5,0.209
31624,2013,19465,1730,7033,6282,751,4855,1427,51554.0,0.203
31624,2014,18717,1546,6787,6115,672,4475,1640,49016.5,0.242
31624,2015,18391,1523,6802,6163,639,4247,1916,52556.0,0.282
31624,2016,18056,1405,6937,6317,620,4053,2264,51865.5,0.326
31624,2017,17818,1345,6934,6342,592,4374,1968,51279.0,0.284
31624,2018,17781,1433,7057,6313,744,4363,1950,55250.0,0.276
31624,2019,17551,1426,6939,6244,695,4474,1770,57553.5,0.255
31625,2010,7541,782,2651,2267,384,1966,301,55033.0,0.114
31625,2011,7784,696,2557,2254,303,1958,296,58097.0,0.116
31625,2012,7803,814,2609,2281,328,1913,368,59327.0,0.141
31625,2013,7310,797,2604,2278,326,1977,301,58203.0,0.116
31625,2014,6926,697,2491,2235,256,1817,418,52120.0,0.168
31625,2015,6640,813,2486,2263,223,1754,509,60430.0,0.205
31625,2016,6714,685,2538,2284,254,1742,542,60550.0,0.214
31625,2017,7167,587,2643,2369,274,1917,452,59639.0,0.171
31625,2018,6393,462,2500,2157,343,1744,413,63701.0,0.165
31625,2019,6452,494,2539,2213,326,1847,366,65576.0,0.144
31626,2010,28273,3395,11322,9735,1587,7496,2239,51818.67,0.198
31626,2011,28161,3312,11414,9888,1526,7375,2513,51435.0,0.22
31626,2012,29392,3373,11389,10021,1368,7343,2678,52934.67,0.235
31626,2013,28817,3166,11101,9748,1353,6922,2826,50373.0,0.255
31626,2014,28588,3346,11250,9994,1256,7097,2897,53597.0,0.258
31626,2015,28751,3138,11175,10015,1160,6851,3164,52370.0,0.283
31626,2016,27769,3125,11229,10209,1020,6673,3536,50564.0,0.315
31626,2017,27035,3166,11127,10124,1003,6850,3274,52137.0,0.294
31626,2018,28536,3783,11605,10522,1083,7269,3253,56237.0,0.28
31626,2019,28221,3644,11315,10308,1007,7111,3197,57667.33,0.283
31629,2010,19833,2752,8461,7208,1253,5162,2046,46156.0,0.242
31629,2011,19479,2692,8472,7243,1229,4958,2285,44104.5,0.27
31629,2012,20763,2551,8501,7321,1180,4837,2484,45027.0,0.292
31629,2013,20848,2431,8258,7151,1107,4603,2548,43334.5,0.309
31629,2014,20806,2493,8203,7262,941,4619,2643,45923.5,0.322
31629,2015,21074,2274,8158,7348,810,4531,2817,45824.0,0.345
31629,2016,20473,2245,8206,7534,672,4384,3150,46314.5,0.384
31629,2017,19261,2301,7945,7316,629,4472,2844,46767.0,0.358
31629,2018,20393,2786,8416,7721,695,4836,2885,50566.5,0.343
31629,2019,19991,2654,8165,7488,677,4668,2820,51501.0,0.345
31630,2010,28351,2376,12832,10535,2297,7684,2851,41763.6,0.222
31630,2011,29077,2832,13096,10633,2463,7899,2734,42996.0,0.209
31630,2012,29556,3087,13198,10955,2243,8315,2640,43924.8,0.2
31630,2013,29956,3335,13256,11000,2256,8473,2527,44546.0,0.191
31630,2014,30578,3822,13442,11098,2344,8538,2560,44870.0,0.19
31630,2015,30665,4022,13511,11153,2358,8457,2696,44964.0,0.2
31630,2016,30718,4274,13427,11174,2253,8447,2727,45579.2,0.203
31630,2017,31445,4579,13627,11245,2382,8366,2879,47476.0,0.211
31630,2018,30957,4351,13546,11235,2311,8384,2851,49502.6,0.21
31630,2019,31554,4218,13692,11468,2224,8705,2763,51589.6,0.202
31631,2010,26762,2329,10798,9332,1466,7073,2259,44223.67,0.209
31631,2011,26972,2797,11019,9557,1462,7188,2369,44789.0,0.215
31631,2012,27148,2693,11115,9682,1433,7436,2246,43861.17,0.202
31631,2013,26573,2608,11084,9654,1430,7471,2183,43634.83,0.197
31631,2014,27093,2838,10965,9677,1288,7483,2194,43699.83,0.2
31631,2015,26598,2795,10908,9587,1321,7272,2315,44004.83,0.212
31631,2016,26919,2472,10953,9579,1374,7345,2234,43857.67,0.204
31631,2017,27589,2640,11010,9649,1361,7304,2345,48000.83,0.213
31631,2018,28424,2755,11084,9822,1262,7493,2329,51590.5,0.21
31631,2019,28099,2793,11012,9689,1323,7562,2127,55834.0,0.193
31634,2010,28351,2376,12832,10535,2297,7684,2851,41763.6,0.222
31634,2011,29077,2832,13096,10633,2463,7899,2734,42996.0,0.209
31634,2012,29556,3087,13198,10955,2243,8315,2640,43924.8,0.2
31634,2013,29956,3335,13256,11000,2256,8473,2527,44546.0,0.191
31634,2014,30578,3822,13442,11098,2344,8538,2560,44870.0,0.19
31634,2015,30665,4022,13511,11153,2358,8457,2696,44964.0,0.2
31634,2016,30718,4274,13427,11174,2253,8447,2727,45579.2,0.203
31634,2017,31445,4579,13627,11245,2382,8366,2879,47476.0,0.211
31634,2018,30957,4351,13546,11235,2311,8384,2851,49502.6,0.21
31634,2019,31554,4218,13692,11468,2224,8705,2763,51589.6,0.202
31635,2010,23022,2103,10911,8967,1944,6352,2615,40420.5,0.24
31635,2011,23522,2470,11156,8960,2196,6449,2511,42042.5,0.225
31635,2012,23482,2700,11036,8938,2098,6576,2362,42993.5,0.214
31635,2013,24564,2869,11102,9126,1976,6698,2428,43707.75,0.219
31635,2014,24816,3029,11406,9262,2144,6743,2519,43683.5,0.221
31635,2015,25172,3180,11573,9327,2246,6806,2521,43853.0,0.218
31635,2016,24870,3450,11510,9384,2126,6769,2615,42863.0,0.227
31635,2017,24938,3734,11731,9444,2287,6781,2663,44586.25,0.227
31635,2018,24205,3477,11787,9482,2305,6757,2725,45933.75,0.231
31635,2019,24843,3367,11839,9632,2207,7114,2518,48485.5,0.213
31637,2010,36374,2775,16186,13394,2792,9417,3977,40287.29,0.246
31637,2011,36961,3238,16449,13451,2998,9590,3861,41793.86,0.235
31637,2012,37120,3656,16515,13674,2841,10017,3657,42589.86,0.221
31637,2013,37398,3948,16564,13708,2856,10161,3547,42879.14,0.214
31637,2014,37607,4503,16682,13809,2873,10215,3594,41248.0,0.215
31637,2015,37703,4633,16674,13790,2884,10083,3707,42592.43,0.222
31637,2016,37809,4860,16611,13805,2806,10090,3715,42881.86,0.224
31637,2017,38236,5043,16862,13867,2995,9950,3917,43842.29,0.232
31637,2018,38222,4741,16893,14064,2829,10059,4005,46904.57,0.237
31637,2019,38856,4534,17056,14261,2795,10328,3933,50372.71,0.231
31638,2010,7541,782,2651,2267,384,1966,301,55033.0,0.114
31638,2011,7784,696,2557,2254,303,1958,296,58097.0,0.116
31638,2012,7803,814,2609,2281,328,1913,368,59327.0,0.141
31638,2013,7310,797,2604,2278,326,1977,301,58203.0,0.116
31638,2014,6926,697,2491,2235,256,1817,418,52120.0,0.168
31638,2015,6640,813,2486,2263,223,1754,509,60430.0,0.205
31638,2016,6714,685,2538,2284,254,1742,542,60550.0,0.214
31638,2017,7167,587,2643,2369,274,1917,452,59639.0,0.171
31638,2018,6393,462,2500,2157,343,1744,413,63701.0,0.165
31638,2019,6452,494,2539,2213,326,1847,366,65576.0,0.144
31639,2010,27803,1980,12396,10407,1989,6909,3498,37172.5,0.282
31639,2011,27259,2000,12404,10236,2168,6645,3591,38068.0,0.29
31639,2012,27377,2188,12339,10134,2205,6908,3226,38437.0,0.261
31639,2013,27009,2097,12130,9913,2217,6664,3249,38616.83,0.268
31639,2014,27185,2493,11977,9963,2014,6625,3338,36713.83,0.279
31639,2015,27146,2456,11920,9811,2109,6349,3462,37340.33,0.29
31639,2016,27474,2517,12050,9888,2162,6513,3375,38719.0,0.28
31639,2017,27760,2506,12178,9921,2257,6477,3444,38856.17,0.283
31639,2018,27966,2425,12234,10257,1977,6658,3599,41242.5,0.294
31639,2019,27930,2086,12050,10050,2000,6713,3337,44820.17,0.277
31642,2010,35858,3154,14956,12516,2440,9648,2868,45538.2,0.192
31642,2011,36731,3525,15076,12604,2472,9775,2829,47389.8,0.188
31642,2012,37891,3920,15506,13140,2366,10092,3048,48800.6,0.197
31642,2013,38563,4236,15602,13372,2230,10386,2986,48886.2,0.191
31642,2014,38002,4263,15624,13290,2334,10054,3236,47964.8,0.207
31642,2015,38025,4412,15733,13437,2296,9955,3482,49952.2,0.221
31642,2016,37479,4554,15723,13612,2111,9673,3939,48476.2,0.251
31642,2017,37550,4737,15916,13734,2182,9948,3786,49586.8,0.238
31642,2018,36899,4567,16048,13640,2408,9916,3724,52302.6,0.232
31642,2019,37341,4553,16115,13845,2270,10295,3550,54582.0,0.22
31643,2010,34578,3842,13882,11862,2020,8846,3016,47178.5,0.217
31643,2011,34564,3799,13927,12048,1879,8645,3403,46718.25,0.244
31643,2012,36180,3682,14098,12281,1817,8325,3956,47412.5,0.281
31643,2013,36123,3589,13883,12159,1724,8010,4149,46380.75,0.299
31643,2014,35666,3877,13745,12286,1459,7908,4378,46108.0,0.319
31643,2015,35876,3801,13663,12488,1175,7809,4679,48616.25,0.342
31643,2016,35243,3658,13734,12607,1127,7651,4956,49873.0,0.361
31643,2017,34840,3760,13674,12523,1151,7923,4600,51507.5,0.336
31643,2018,35066,4207,13991,12707,1284,8240,4467,55525.0,0.319
31643,2019,34814,3869,13749,12476,1273,8162,4314,57823.5,0.314
31645,2010,3219,248,1517,1188,329,766,422,39630.0,0.278
31645,2011,2972,200,1531,1123,408,754,369,40795.0,0.241
31645,2012,3037,208,1600,1198,402,867,331,39695.0,0.207
31645,2013,3243,292,1602,1259,343,867,392,39362.0,0.245
31645,2014,3332,395,1563,1242,321,825,417,40395.0,0.267
31645,2015,3539,421,1535,1242,293,876,366,39781.0,0.238
31645,2016,3641,505,1501,1289,212,894,395,37989.0,0.263
31645,2017,4050,513,1549,1394,155,894,500,38648.0,0.323
31645,2018,3775,475,1536,1365,171,948,417,37414.0,0.271
31645,2019,3811,439,1507,1359,148,913,446,37976.0,0.296
31647,2010,18452,1581,6847,5945,902,4835,1110,48773.5,0.162
31647,2011,18633,1571,6710,5955,755,4701,1254,50196.0,0.187
31647,2012,19760,1732,7100,6302,798,4816,1486,52207.5,0.209
31647,2013,19465,1730,7033,6282,751,4855,1427,51554.0,0.203
31647,2014,18717,1546,6787,6115,672,4475,1640,49016.5,0.242
31647,2015,18391,1523,6802,6163,639,4247,1916,52556.0,0.282
31647,2016,18056,1405,6937,6317,620,4053,2264,51865.5,0.326
31647,2017,17818,1345,6934,6342,592,4374,1968,51279.0,0.284
31647,2018,17781,1433,7057,6313,744,4363,1950,55250.0,0.276
31647,2019,17551,1426,6939,6244,695,4474,1770,57553.5,0.255
31649,2010,17406,1573,8109,6571,1538,4813,1758,43381.33,0.217
31649,2011,18098,1954,8366,6649,1717,5074,1575,45519.0,0.188
31649,2012,18131,2188,8406,6838,1568,5276,1562,46529.33,0.186
31649,2013,19098,2506,8569,7090,1479,5531,1559,47107.67,0.182
31649,2014,19285,2717,8837,7175,1662,5579,1596,47263.67,0.181
31649,2015,19634,2889,8931,7274,1657,5708,1566,48216.33,0.175
31649,2016,19423,3149,8786,7295,1491,5620,1675,46216.67,0.191
31649,2017,19732,3392,8982,7392,1590,5574,1818,48458.67,0.202
31649,2018,19118,3134,8991,7327,1664,5553,1774,50337.67,0.197
31649,2019,19790,3127,9176,7601,1575,5821,1780,52601.0,0.194
31650,2010,10911,799,4196,3678,518,2869,809,42514.0,0.193
31650,2011,10849,875,4153,3701,452,2743,958,42295.0,0.231
31650,2012,11957,918,4491,4021,470,2903,1118,45088.0,0.249
31650,2013,12155,933,4429,4004,425,2878,1126,44905.0,0.254
31650,2014,11791,849,4296,3880,416,2658,1222,45913.0,0.284
31650,2015,11751,710,4316,3900,416,2493,1407,44682.0,0.326
31650,2016,11342,720,4399,4033,366,2311,1722,43181.0,0.391
31650,2017,10651,758,4291,3973,318,2457,1516,42919.0,0.353
31650,2018,11388,971,4557,4156,401,2619,1537,46799.0,0.337
31650,2019,11099,932,4400,4031,369,2627,1404,49531.0,0.319
31698,2010,2191,555,1393,1083,310,705,378,46354.0,0.271
31698,2011,2148,606,1394,1089,305,692,397,47264.0,0.285
31698,2012,2246,622,1370,1104,266,645,459,47167.0,0.335
31698,2013,2144,571,1362,1060,302,600,460,45515.0,0.338
31698,2014,2189,605,1401,1100,301,641,459,48447.0,0.328
31698,2015,2309,558,1436,1157,279,716,441,47691.0,0.307
31698,2016,2399,538,1462,1177,285,713,464,49638.0,0.317
31698,2017,2420,564,1489,1196,293,754,442,51848.0,0.297
31698,2018,2376,615,1413,1149,264,747,402,56308.0,0.285
31698,2019,2365,707,1406,1148,258,667,481,60333.0,0.342
31701,2010,36240,11311,16786,13989,2797,7427,6562,62345.89,0.391
31701,2011,35929,12037,17059,14160,2899,7772,6388,67961.56,0.374
31701,2012,36421,11263,17016,14099,2917,7594,6505,70857.78,0.382
31701,2013,35871,11523,16992,14164,2828,7718,6446,71928.22,0.379
31701,2014,36085,11938,17154,14328,2826,7781,6547,69745.11,0.382
31701,2015,36487,11908,17264,14580,2684,7624,6956,73988.44,0.403
31701,2016,37132,12415,17576,14766,2810,7827,6939,74134.0,0.395
31701,2017,37925,13312,17765,15079,2686,8146,6933,77699.78,0.39
31701,2018,39804,14188,18017,15559,2458,8351,7208,81778.22,0.4
31701,2019,40626,14339,18206,15777,2429,8526,7251,87078.67,0.398
31703,2010,4433,2536,2210,2023,187,1688,335,114922.0,0.152
31703,2011,4327,2521,2117,1896,221,1539,357,125792.0,0.169
31703,2012,4225,2347,2055,1848,207,1479,369,123676.0,0.18
31703,2013,4319,2336,2017,1877,140,1544,333,125819.0,0.165
31703,2014,4469,2394,2006,1807,199,1504,303,128578.0,0.151
31703,2015,4650,2647,2044,1847,197,1521,326,139487.0,0.159
31703,2016,4781,2633,2045,1856,189,1509,347,138276.0,0.17
31703,2017,5183,2898,2098,1969,129,1574,395,149450.0,0.188
31703,2018,5373,2967,2151,1997,154,1534,463,154911.0,0.215
31703,2019,5410,3142,2140,2084,56,1572,512,168396.0,0.239
31705,2010,29358,7776,13476,11832,1644,8251,3581,66666.8,0.266
31705,2011,28838,7707,13384,11589,1795,8088,3501,67282.2,0.262
31705,2012,28911,7455,13223,11501,1722,7792,3709,67582.2,0.28
31705,2013,29437,7908,13270,11703,1567,8096,3607,68795.8,0.272
31705,2014,30256,8336,13221,11752,1469,8166,3586,72071.2,0.271
31705,2015,30692,8875,13262,11883,1379,8301,3582,72621.0,0.27
31705,2016,30711,8948,13144,11771,1373,8296,3475,74606.4,0.264
31705,2017,31475,9364,13164,11824,1340,8584,3240,82387.4,0.246
31705,2018,31931,9475,13134,11984,1150,8672,3312,87806.6,0.252
31705,2019,32688,9975,13481,12482,999,9098,3384,95369.2,0.251
31706,2010,4429,2346,3079,2431,648,772,1659,53246.0,0.539
31706,2011,4265,2470,3030,2335,695,893,1442,64531.0,0.476
31706,2012,4121,2301,2953,2338,615,887,1451,61815.0,0.491
31706,2013,3967,2187,2897,2289,608,836,1453,60722.0,0.502
31706,2014,4192,2393,2863,2396,467,873,1523,61362.0,0.532
31706,2015,4366,2350,2886,2511,375,790,1721,60182.0,0.596
31706,2016,4308,2275,2932,2487,445,824,1663,60356.0,0.567
31706,2017,4637,2459,2845,2437,408,890,1547,63464.0,0.544
31706,2018,4649,2695,2793,2505,288,1029,1476,70404.0,0.528
31706,2019,4617,2633,2772,2405,367,879,1526,66490.0,0.551
31707,2010,18589,5620,10681,8527,2154,4792,3735,57524.2,0.35
31707,2011,20304,6390,11199,9025,2174,5113,3912,59913.4,0.349
31707,2012,21547,6348,11471,9357,2114,5173,4184,60608.8,0.365
31707,2013,21223,6296,11648,9344,2304,5082,4262,61834.8,0.366
31707,2014,21692,6439,12018,9643,2375,5243,4400,61331.6,0.366
31707,2015,21659,6224,12147,9730,2417,4879,4851,66014.2,0.399
31707,2016,22345,6816,12272,9769,2503,5005,4764,64884.0,0.388
31707,2017,22562,7478,12818,10141,2677,5369,4772,68683.8,0.372
31707,2018,24039,8035,13425,10659,2766,5572,5087,70512.6,0.379
31707,2019,25693,9186,14192,11443,2749,5872,5571,75984.4,0.393
31711,2010,10911,799,4196,3678,518,2869,809,42514.0,0.193
31711,2011,10849,875,4153,3701,452,2743,958,42295.0,0.231
31711,2012,11957,918,4491,4021,470,2903,1118,45088.0,0.249
31711,2013,12155,933,4429,4004,425,2878,1126,44905.0,0.254
31711,2014,11791,849,4296,3880,416,2658,1222,45913.0,0.284
31711,2015,11751,710,4316,3900,416,2493,1407,44682.0,0.326
31711,2016,11342,720,4399,4033,366,2311,1722,43181.0,0.391
31711,2017,10651,758,4291,3973,318,2457,1516,42919.0,0.353
31711,2018,11388,971,4557,4156,401,2619,1537,46799.0,0.337
31711,2019,11099,932,4400,4031,369,2627,1404,49531.0,0.319
31712,2010,32584,3659,13694,11762,1932,8449,3313,39572.5,0.242
31712,2011,32328,4036,13736,11692,2044,8651,3041,43684.33,0.221
31712,2012,33294,3803,13834,11914,1920,8874,3040,43969.0,0.22
31712,2013,32298,3613,13555,11565,1990,8641,2924,45314.33,0.216
31712,2014,32595,3903,13596,11567,2029,8717,2850,46430.67,0.21
31712,2015,31888,3792,13662,11509,2153,8408,3101,47992.17,0.227
31712,2016,32408,3572,13758,11636,2122,8476,3160,47974.83,0.23
31712,2017,33114,3835,14016,11692,2324,8650,3042,49677.17,0.217
31712,2018,33211,3671,14021,11764,2257,8684,3080,52281.0,0.22
31712,2019,33475,3759,13937,11800,2137,8825,2975,58364.17,0.213
31714,2010,18968,1202,8077,6823,1254,4604,2219,37966.75,0.275
31714,2011,18863,1284,8083,6802,1281,4516,2286,39000.0,0.283
31714,2012,18989,1468,8109,6836,1273,4741,2095,39635.25,0.258
31714,2013,18300,1442,7995,6618,1377,4630,1988,39707.75,0.249
31714,2014,18322,1786,7845,6634,1211,4636,1998,36736.25,0.255
31714,2015,18069,1744,7743,6516,1227,4375,2141,38374.5,0.277
31714,2016,18386,1711,7825,6510,1315,4470,2040,40380.75,0.261
31714,2017,18504,1651,7880,6475,1405,4376,2099,40380.0,0.266
31714,2018,19104,1607,7902,6737,1165,4506,2231,44329.75,0.282
31714,2019,19066,1407,7880,6660,1220,4507,2153,48701.5,0.273
31716,2010,24812,4807,10066,8972,1094,7889,1083,64561.0,0.108
31716,2011,26475,4858,10622,9440,1182,8021,1419,64510.67,0.134
31716,2012,27197,5171,10829,9654,1175,8071,1583,66329.67,0.146
31716,2013,27346,5277,10957,9672,1285,8023,1649,66356.33,0.15
31716,2014,29065,6231,11146,10125,1021,8403,1722,69782.67,0.154
31716,2015,29428,6272,11112,10187,925,8467,1720,68873.0,0.155
31716,2016,29929,6431,11012,10130,882,8625,1505,71081.67,0.137
31716,2017,29971,6486,11345,10447,898,9158,1289,71491.0,0.114
31716,2018,30842,6731,11585,10892,693,9630,1262,82064.0,0.109
31716,2019,31059,6983,12134,11498,636,9757,1741,82642.0,0.143
31719,2010,10911,799,4196,3678,518,2869,809,42514.0,0.193
31719,2011,10849,875,4153,3701,452,2743,958,42295.0,0.231
31719,2012,11957,918,4491,4021,470,2903,1118,45088.0,0.249
31719,2013,12155,933,4429,4004,425,2878,1126,44905.0,0.254
31719,2014,11791,849,4296,3880,416,2658,1222,45913.0,0.284
31719,2015,11751,710,4316,3900,416,2493,1407,44682.0,0.326
31719,2016,11342,720,4399,4033,366,2311,1722,43181.0,0.391
31719,2017,10651,758,4291,3973,318,2457,1516,42919.0,0.353
31719,2018,11388,971,4557,4156,401,2619,1537,46799.0,0.337
31719,2019,11099,932,4400,4031,369,2627,1404,49531.0,0.319
31720,2010,10911,799,4196,3678,518,2869,809,42514.0,0.193
31720,2011,10849,875,4153,3701,452,2743,958,42295.0,0.231
31720,2012,11957,918,4491,4021,470,2903,1118,45088.0,0.249
31720,2013,12155,933,4429,4004,425,2878,1126,44905.0,0.254
31720,2014,11791,849,4296,3880,416,2658,1222,45913.0,0.284
31720,2015,11751,710,4316,3900,416,2493,1407,44682.0,0.326
31720,2016,11342,720,4399,4033,366,2311,1722,43181.0,0.391
31720,2017,10651,758,4291,3973,318,2457,1516,42919.0,0.353
31720,2018,11388,971,4557,4156,401,2619,1537,46799.0,0.337
31720,2019,11099,932,4400,4031,369,2627,1404,49531.0,0.319
31721,2010,9639,1044,4417,3693,724,2618,1075,36253.5,0.243
31721,2011,9648,1210,4352,3642,710,2774,868,40375.5,0.199
31721,2012,9996,1064,4447,3690,757,2828,862,41427.0,0.194
31721,2013,9975,1085,4458,3718,740,2840,878,43452.0,0.197
31721,2014,9837,1121,4540,3764,776,2837,927,48936.0,0.204
31721,2015,9916,1045,4559,3773,786,2716,1057,51355.0,0.232
31721,2016,10067,952,4657,3842,815,2787,1055,49690.0,0.227
31721,2017,10051,977,4745,3875,870,2851,1024,50694.0,0.216
31721,2018,9929,940,4811,3863,948,2858,1005,51536.5,0.209
31721,2019,10501,1203,4892,3998,894,3051,947,59776.5,0.194
31722,2010,5616,530,2802,2396,406,1539,857,31538.0,0.306
31722,2011,5424,516,2790,2311,479,1375,936,31613.0,0.335
31722,2012,5351,512,2630,2100,530,1300,800,32386.0,0.304
31722,2013,5466,363,2533,2036,497,1167,869,33508.0,0.343
31722,2014,5531,312,2569,2087,482,1164,923,32943.0,0.359
31722,2015,5538,291,2642,2053,589,1098,955,30763.0,0.361
31722,2016,5447,301,2724,2089,635,1149,940,32802.0,0.345
31722,2017,5206,342,2749,2052,697,1207,845,32969.0,0.307
31722,2018,5087,343,2796,2155,641,1204,951,32722.0,0.34
31722,2019,5053,240,2663,2031,632,1293,738,36139.0,0.277
31727,2010,7204,308,2770,2387,383,1718,669,41369.0,0.242
31727,2011,7301,411,2898,2551,347,1729,822,40567.0,0.284
31727,2012,7614,317,2988,2679,309,1575,1104,40269.0,0.369
31727,2013,7965,361,3021,2730,291,1430,1300,40651.0,0.43
31727,2014,7934,687,3051,2789,262,1472,1317,40465.0,0.432
31727,2015,8162,714,3019,2877,142,1524,1353,42387.0,0.448
31727,2016,8056,728,2990,2789,201,1525,1264,46313.0,0.423
31727,2017,8412,872,3086,2838,248,1534,1304,52857.0,0.423
31727,2018,8280,959,3075,2829,246,1660,1169,57266.0,0.38
31727,2019,8371,721,3045,2775,270,1647,1128,62716.0,0.37
31730,2010,50680,7427,22148,18837,3311,14156,4681,51225.86,0.211
31730,2011,52517,7833,22917,19283,3634,14474,4809,52158.0,0.21
31730,2012,54097,8372,23248,19889,3359,14871,5018,53706.86,0.216
31730,2013,55777,8654,23603,20167,3436,15006,5161,53640.86,0.219
31730,2014,57941,9933,24083,20876,3207,15468,5408,55457.14,0.225
31730,2015,58898,10165,23959,21022,2937,15497,5525,55495.14,0.231
31730,2016,59440,10786,23712,21046,2666,15610,5436,55781.71,0.229
31730,2017,59299,11112,24173,21452,2721,16056,5396,57123.43,0.223
31730,2018,59248,11317,24492,21881,2611,16508,5373,62890.71,0.219
31730,2019,59959,11565,25242,22733,2509,16992,5741,64549.57,0.227
31733,2010,7204,308,2770,2387,383,1718,669,41369.0,0.242
31733,2011,7301,411,2898,2551,347,1729,822,40567.0,0.284
31733,2012,7614,317,2988,2679,309,1575,1104,40269.0,0.369
31733,2013,7965,361,3021,2730,291,1430,1300,40651.0,0.43
31733,2014,7934,687,3051,2789,262,1472,1317,40465.0,0.432
31733,2015,8162,714,3019,2877,142,1524,1353,42387.0,0.448
31733,2016,8056,728,2990,2789,201,1525,1264,46313.0,0.423
31733,2017,8412,872,3086,2838,248,1534,1304,52857.0,0.423
31733,2018,8280,959,3075,2829,246,1660,1169,57266.0,0.38
31733,2019,8371,721,3045,2775,270,1647,1128,62716.0,0.37
31738,2010,10760,1030,4168,3455,713,2732,723,47331.5,0.173
31738,2011,10756,896,4088,3377,711,2712,665,49446.0,0.163
31738,2012,10840,1022,4209,3479,730,2780,699,49511.0,0.166
31738,2013,10553,1089,4206,3537,669,2844,693,48782.5,0.165
31738,2014,10258,1092,4054,3477,577,2642,835,46257.5,0.206
31738,2015,10179,1234,4021,3505,516,2630,875,50105.5,0.218
31738,2016,10355,1190,4039,3573,466,2636,937,49269.5,0.232
31738,2017,11217,1100,4192,3763,429,2811,952,49143.5,0.227
31738,2018,10168,937,4036,3522,514,2692,830,50557.5,0.206
31738,2019,10263,933,4046,3572,474,2760,812,51776.0,0.201
31743,2010,1735,931,746,720,26,520,200,132917.0,0.268
31743,2011,1695,871,721,696,25,528,168,136429.0,0.233
31743,2012,1720,957,711,679,32,544,135,160662.0,0.19
31743,2013,1838,1004,707,707,0,554,153,159362.0,0.216
31743,2014,1853,1045,758,758,0,576,182,130385.0,0.24
31743,2015,1908,1106,754,731,23,571,160,153177.0,0.212
31743,2016,2006,1198,842,796,46,573,223,162500.0,0.265
31743,2017,2076,1231,840,785,55,580,205,174526.0,0.244
31743,2018,2141,1313,845,799,46,601,198,184875.0,0.234
31743,2019,1997,1192,803,737,66,550,187,170096.0,0.233
31744,2010,25086,2865,10805,9335,1470,7473,1862,48718.25,0.172
31744,2011,26029,2858,11062,9539,1523,7530,2009,49180.25,0.182
31744,2012,26930,2842,11229,9805,1424,7754,2051,50303.0,0.183
31744,2013,26409,2922,11252,9599,1653,7617,1982,50444.75,0.176
31744,2014,27687,3654,11214,9810,1404,7873,1937,50917.5,0.173
31744,2015,28056,3787,11216,9794,1422,7653,2141,50721.0,0.191
31744,2016,28620,3982,11220,9743,1477,7697,2046,54275.0,0.182
31744,2017,29069,4150,11394,9865,1529,7880,1985,55855.0,0.174
31744,2018,30203,4389,11427,10279,1148,8339,1940,63239.75,0.17
31744,2019,30279,4627,11703,10595,1108,8706,1889,65987.75,0.161
31747,2010,5616,530,2802,2396,406,1539,857,31538.0,0.306
31747,2011,5424,516,2790,2311,479,1375,936,31613.0,0.335
31747,2012,5351,512,2630,2100,530,1300,800,32386.0,0.304
31747,2013,5466,363,2533,2036,497,1167,869,33508.0,0.343
31747,2014,5531,312,2569,2087,482,1164,923,32943.0,0.359
31747,2015,5538,291,2642,2053,589,1098,955,30763.0,0.361
31747,2016,5447,301,2724,2089,635,1149,940,32802.0,0.345
31747,2017,5206,342,2749,2052,697,1207,845,32969.0,0.307
31747,2018,5087,343,2796,2155,641,1204,951,32722.0,0.34
31747,2019,5053,240,2663,2031,632,1293,738,36139.0,0.277
31749,2010,18149,1111,7493,6351,1142,4589,1762,40014.33,0.235
31749,2011,18280,1289,7628,6535,1093,4554,1981,39663.33,0.26
31749,2012,19039,1216,7780,6796,984,4614,2182,40101.67,0.28
31749,2013,18823,1190,7708,6640,1068,4372,2268,40686.0,0.294
31749,2014,19227,1792,7656,6712,944,4431,2281,41008.0,0.298
31749,2015,19193,1847,7599,6756,843,4273,2483,40852.67,0.327
31749,2016,19351,1853,7631,6668,963,4352,2316,45186.33,0.303
31749,2017,20125,2059,7731,6691,1040,4326,2365,48287.0,0.306
31749,2018,20119,2176,7630,6737,893,4491,2246,51255.33,0.294
31749,2019,20135,1812,7561,6642,919,4531,2111,54287.0,0.279
31750,2010,25656,1889,9617,8332,1285,6553,1779,46305.33,0.185
31750,2011,25934,1982,9608,8506,1102,6430,2076,46986.33,0.216
31750,2012,27374,2049,10088,8981,1107,6391,2590,48228.0,0.257
31750,2013,27430,2091,10054,9012,1042,6285,2727,47919.67,0.271
31750,2014,26651,2233,9838,8904,934,5947,2957,46166.0,0.301
31750,2015,26553,2237,9821,9040,781,5771,3269,49166.33,0.333
31750,2016,26112,2133,9927,9106,821,5578,3528,50014.67,0.355
31750,2017,26230,2217,10020,9180,840,5908,3272,51805.0,0.327
31750,2018,26061,2392,10132,9142,990,6023,3119,55922.0,0.308
31750,2019,25922,2147,9984,9019,965,6121,2898,59274.33,0.29
31756,2010,10945,803,4723,3964,759,2871,1093,39337.0,0.231
31756,2011,10979,878,4730,3984,746,2825,1159,39211.5,0.245
31756,2012,11425,899,4792,4117,675,3039,1078,40018.0,0.225
31756,2013,10858,829,4687,3910,777,2942,968,40703.5,0.207
31756,2014,11293,1105,4605,3923,682,2959,964,41279.5,0.209
31756,2015,11031,1133,4580,3879,701,2749,1130,40085.5,0.247
31756,2016,11295,1125,4641,3879,762,2827,1052,44623.0,0.227
31756,2017,11713,1187,4645,3853,792,2792,1061,46002.0,0.228
31756,2018,11839,1217,4555,3908,647,2831,1077,48250.0,0.236
31756,2019,11764,1091,4516,3867,649,2884,983,50072.5,0.218
31757,2010,40377,3179,15680,13531,2149,10212,3319,47713.0,0.212
31757,2011,41143,3227,15888,13855,2033,10209,3646,49740.6,0.229
31757,2012,42395,3506,16235,14312,1923,10064,4248,51078.4,0.262
31757,2013,41515,3321,15921,14013,1908,9573,4440,49159.6,0.279
31757,2014,40886,3745,15862,14153,1709,9396,4757,50214.6,0.3
31757,2015,41502,3763,15973,14431,1542,9171,5260,51330.2,0.329
31757,2016,41065,3933,16128,14622,1506,8845,5777,50285.0,0.358
31757,2017,41974,4096,16371,14833,1538,9294,5539,51744.2,0.338
31757,2018,42296,4430,16676,14970,1706,9605,5365,55483.8,0.322
31757,2019,41971,4223,16560,14923,1637,9863,5060,58367.6,0.306
31763,2010,7580,4078,3673,3359,314,2261,1098,101585.0,0.299
31763,2011,7622,4103,3583,3305,278,2150,1155,101285.67,0.322
31763,2012,7515,4184,3557,3260,297,2103,1157,111760.33,0.325
31763,2013,7752,4305,3524,3227,297,2131,1096,114320.67,0.311
31763,2014,7660,4377,3570,3245,325,2120,1125,107202.33,0.315
31763,2015,7816,4571,3642,3327,315,2185,1142,119293.67,0.314
31763,2016,8201,4740,3790,3420,370,2301,1119,120077.33,0.295
31763,2017,8272,4846,3756,3429,327,2354,1075,125167.67,0.286
31763,2018,8323,4885,3726,3405,321,2338,1067,132246.0,0.286
31763,2019,8354,4898,3663,3395,268,2385,1010,134192.33,0.276
31764,2010,3758,2040,1997,1843,154,1108,735,99877.5,0.368
31764,2011,3794,2066,1928,1788,140,1090,698,102154.0,0.362
31764,2012,3785,2154,1917,1747,170,1075,672,117387.5,0.351
31764,2013,3919,2191,1855,1702,153,1088,614,119325.5,0.331
31764,2014,3893,2269,1913,1738,175,1095,643,108942.5,0.336
31764,2015,3997,2344,1938,1756,182,1142,614,128003.0,0.317
31764,2016,4145,2457,2032,1790,242,1150,640,129154.5,0.315
31764,2017,4121,2502,1993,1769,224,1162,607,131207.5,0.305
31764,2018,4040,2525,1990,1769,221,1139,630,134859.5,0.317
31764,2019,3878,2483,1938,1720,218,1121,599,127481.5,0.309
31765,2010,7203,1137,3114,2728,386,2297,431,54815.0,0.138
31765,2011,7502,1131,3127,2717,410,2332,385,56938.0,0.123
31765,2012,7389,1092,3121,2701,420,2311,390,59731.0,0.125
31765,2013,7438,1084,3168,2636,532,2220,416,59965.0,0.131
31765,2014,7854,1320,3110,2723,387,2348,375,59413.0,0.121
31765,2015,8095,1316,3075,2720,355,2326,394,65407.0,0.128
31765,2016,8360,1417,3114,2707,407,2273,434,66850.0,0.139
31765,2017,8482,1379,3175,2764,411,2322,442,65549.0,0.139
31765,2018,8830,1563,3116,2868,248,2457,411,85045.0,0.132
31765,2019,8370,1753,3245,2963,282,2585,378,89522.0,0.116
31768,2010,44776,3361,20170,16639,3531,11686,4953,39609.44,0.246
31768,2011,45302,3717,20398,16563,3835,11732,4831,40989.33,0.237
31768,2012,45551,4212,20519,16901,3618,12288,4613,41654.22,0.225
31768,2013,45817,4559,20527,16942,3585,12395,4547,41313.89,0.222
31768,2014,45942,5142,20704,17114,3590,12399,4715,40484.0,0.228
31768,2015,46198,5320,20645,16962,3683,12269,4693,41557.56,0.227
31768,2016,46541,5685,20547,17065,3482,12332,4733,41394.11,0.23
31768,2017,47271,5819,20838,17224,3614,12197,5027,42171.89,0.241
31768,2018,46954,5509,20896,17324,3572,12271,5053,44487.78,0.242
31768,2019,47188,5237,21022,17413,3609,12409,5004,47115.78,0.238
31771,2010,31045,2502,14265,11826,2439,8085,3741,39145.83,0.262
31771,2011,31406,2876,14509,11778,2731,8140,3638,40957.83,0.251
31771,2012,31046,3269,14353,11657,2696,8278,3379,41746.5,0.235
31771,2013,32006,3482,14410,11834,2576,8386,3448,42042.5,0.239
31771,2014,31845,3710,14646,11973,2673,8420,3553,39853.33,0.243
31771,2015,32210,3791,14736,11964,2772,8432,3532,41456.5,0.24
31771,2016,31961,4036,14694,12015,2679,8412,3603,40621.5,0.245
31771,2017,31729,4198,14966,12066,2900,8365,3701,41310.17,0.247
31771,2018,31470,3867,15134,12311,2823,8432,3879,44092.33,0.256
31771,2019,32145,3683,15203,12425,2778,8737,3688,48100.5,0.243
31773,2010,10911,799,4196,3678,518,2869,809,42514.0,0.193
31773,2011,10849,875,4153,3701,452,2743,958,42295.0,0.231
31773,2012,11957,918,4491,4021,470,2903,1118,45088.0,0.249
31773,2013,12155,933,4429,4004,425,2878,1126,44905.0,0.254
31773,2014,11791,849,4296,3880,416,2658,1222,45913.0,0.284
31773,2015,11751,710,4316,3900,416,2493,1407,44682.0,0.326
31773,2016,11342,720,4399,4033,366,2311,1722,43181.0,0.391
31773,2017,10651,758,4291,3973,318,2457,1516,42919.0,0.353
31773,2018,11388,971,4557,4156,401,2619,1537,46799.0,0.337
31773,2019,11099,932,4400,4031,369,2627,1404,49531.0,0.319
31774,2010,17406,1573,8109,6571,1538,4813,1758,43381.33,0.217
31774,2011,18098,1954,8366,6649,1717,5074,1575,45519.0,0.188
31774,2012,18131,2188,8406,6838,1568,5276,1562,46529.33,0.186
31774,2013,19098,2506,8569,7090,1479,5531,1559,47107.67,0.182
31774,2014,19285,2717,8837,7175,1662,5579,1596,47263.67,0.181
31774,2015,19634,2889,8931,7274,1657,5708,1566,48216.33,0.175
31774,2016,19423,3149,8786,7295,1491,5620,1675,46216.67,0.191
31774,2017,19732,3392,8982,7392,1590,5574,1818,48458.67,0.202
31774,2018,19118,3134,8991,7327,1664,5553,1774,50337.67,0.197
31774,2019,19790,3127,9176,7601,1575,5821,1780,52601.0,0.194
31775,2010,28317,2372,12305,10249,2056,7682,2567,43164.5,0.209
31775,2011,28947,2829,12519,10350,2169,7817,2533,44713.0,0.202
31775,2012,30088,3106,12897,10859,2038,8179,2680,46169.0,0.208
31775,2013,31253,3439,12998,11094,1904,8409,2685,46557.0,0.207
31775,2014,31076,3566,13133,11055,2078,8237,2818,46926.0,0.215
31775,2015,31385,3599,13247,11174,2073,8201,2973,47332.75,0.224
31775,2016,30765,3869,13185,11328,1857,7931,3397,45457.75,0.258
31775,2017,30383,4150,13273,11365,1908,8031,3334,47073.75,0.251
31775,2018,30506,4105,13548,11483,2065,8172,3311,49453.0,0.244
31775,2019,30889,4059,13576,11632,1944,8448,3184,51833.5,0.235
31776,2010,8023,399,3354,2859,495,1733,1126,36596.5,0.336
31776,2011,7884,406,3353,2818,535,1691,1127,38788.5,0.336
31776,2012,7564,569,3317,2719,598,1702,1017,39252.5,0.307
31776,2013,7442,613,3308,2708,600,1688,1020,38712.0,0.308
31776,2014,7029,681,3240,2711,529,1677,1034,32193.0,0.319
31776,2015,7038,611,3163,2637,526,1626,1011,36663.5,0.32
31776,2016,7091,586,3184,2631,553,1643,988,36138.5,0.31
31776,2017,6791,464,3235,2622,613,1584,1038,34758.0,0.321
31776,2018,7265,390,3347,2829,518,1675,1154,40409.5,0.345
31776,2019,7302,316,3364,2793,571,1623,1170,47330.5,0.348
31778,2010,27287,2359,11166,9529,1637,7140,2389,42178.75,0.214
31778,2011,27029,2287,11031,9389,1642,6830,2559,43200.0,0.232
31778,2012,28148,2452,11330,9600,1730,6983,2617,44124.0,0.231
31778,2013,28174,2385,11168,9577,1591,6889,2688,43994.5,0.241
31778,2014,27580,2253,10919,9444,1475,6464,2980,42842.75,0.273
31778,2015,27468,2235,10979,9458,1521,6221,3237,43914.0,0.295
31778,2016,27144,2211,11162,9695,1467,6096,3599,43630.5,0.322
31778,2017,27074,2200,11232,9788,1444,6475,3313,43543.75,0.295
31778,2018,26643,2251,11389,9833,1556,6515,3318,45159.0,0.291
31778,2019,26415,2105,11109,9634,1475,6680,2954,47305.5,0.266
31779,2010,15665,2184,7087,6022,1065,3751,2271,44784.5,0.32
31779,2011,15446,2152,7056,5911,1145,3711,2200,45977.5,0.312
31779,2012,16158,2105,7134,6098,1036,3835,2263,48551.0,0.317
31779,2013,16771,1955,7245,6041,1204,3672,2369,47529.5,0.327
31779,2014,17445,2305,7210,6299,911,3834,2465,48237.0,0.342
31779,2015,17931,2320,6991,6281,710,3648,2633,51302.5,0.377
31779,2016,18448,2623,7028,6328,700,3638,2690,52713.5,0.383
31779,2017,18078,2613,7021,6377,644,3646,2731,52782.0,0.389
31779,2018,18118,3015,7032,6530,502,3782,2748,64037.5,0.391
31779,2019,17480,3208,7177,6597,580,3999,2598,67820.0,0.362
31780,2010,10911,799,4196,3678,518,2869,809,42514.0,0.193
31780,2011,10849,875,4153,3701,452,2743,958,42295.0,0.231
31780,2012,11957,918,4491,4021,470,2903,1118,45088.0,0.249
31780,2013,12155,933,4429,4004,425,2878,1126,44905.0,0.254
31780,2014,11791,849,4296,3880,416,2658,1222,45913.0,0.284
31780,2015,11751,710,4316,3900,416,2493,1407,44682.0,0.326
31780,2016,11342,720,4399,4033,366,2311,1722,43181.0,0.391
31780,2017,10651,758,4291,3973,318,2457,1516,42919.0,0.353
31780,2018,11388,971,4557,4156,401,2619,1537,46799.0,0.337
31780,2019,11099,932,4400,4031,369,2627,1404,49531.0,0.319
31782,2010,4132,129,1686,1257,429,418,839,30456.0,0.498
31782,2011,3741,124,1602,1158,444,331,827,25722.0,0.516
31782,2012,3337,136,1549,1112,437,311,801,23623.0,0.517
31782,2013,3171,95,1486,1011,475,313,698,22411.0,0.47
31782,2014,3183,125,1429,983,446,258,725,24129.0,0.507
31782,2015,3097,130,1412,1028,384,280,748,23043.0,0.53
31782,2016,2992,141,1420,975,445,289,686,22863.0,0.483
31782,2017,3375,217,1353,1002,351,330,672,27344.0,0.497
31782,2018,3048,235,1233,991,242,314,677,27401.0,0.549
31782,2019,3036,267,1227,969,258,346,623,23546.0,0.508
31783,2010,29879,2001,12273,10501,1772,7473,3028,38876.2,0.247
31783,2011,29712,2159,12236,10503,1733,7259,3244,39659.0,0.265
31783,2012,30946,2386,12600,10857,1743,7644,3213,40725.8,0.255
31783,2013,30455,2375,12424,10622,1802,7508,3114,40747.2,0.251
31783,2014,30113,2635,12141,10514,1627,7294,3220,38571.6,0.265
31783,2015,29820,2454,12059,10416,1643,6868,3548,39636.0,0.294
31783,2016,29728,2431,12224,10543,1681,6781,3762,40940.8,0.308
31783,2017,29155,2409,12171,10448,1723,6833,3615,40887.8,0.297
31783,2018,30492,2578,12459,10893,1566,7125,3768,44823.6,0.302
31783,2019,30165,2339,12280,10691,1589,7134,3557,48867.4,0.29
31784,2010,18148,1940,7837,6692,1145,5168,1524,44496.33,0.194
31784,2011,18481,2009,7857,6701,1156,5157,1544,45120.33,0.197
31784,2012,18814,1991,7913,6818,1095,5350,1468,46589.0,0.186
31784,2013,18296,1913,7855,6546,1309,5162,1384,47124.0,0.176
31784,2014,19147,2425,7715,6646,1069,5307,1339,47324.0,0.174
31784,2015,19126,2449,7655,6599,1056,5075,1524,48526.0,0.199
31784,2016,19655,2542,7755,6586,1169,5100,1486,52032.0,0.192
31784,2017,20195,2566,7820,6617,1203,5114,1503,52517.67,0.192
31784,2018,20669,2780,7671,6776,895,5288,1488,60515.0,0.194
31784,2019,20134,2844,7761,6830,931,5469,1361,63222.33,0.175
31787,2010,5845,3147,2927,2639,288,1741,898,85919.0,0.307
31787,2011,5927,3232,2862,2609,253,1622,987,83714.0,0.345
31787,2012,5795,3227,2846,2581,265,1559,1022,87309.5,0.359
31787,2013,5914,3301,2817,2520,297,1577,943,91800.0,0.335
31787,2014,5807,3332,2812,2487,325,1544,943,95611.0,0.335
31787,2015,5908,3465,2888,2596,292,1614,982,102352.0,0.34
31787,2016,6195,3542,2948,2624,324,1728,896,98866.0,0.304
31787,2017,6196,3615,2916,2644,272,1774,870,100488.5,0.298
31787,2018,6182,3572,2881,2606,275,1737,869,105931.5,0.302
31787,2019,6357,3706,2860,2658,202,1835,823,116240.5,0.288
31788,2010,27287,2359,11166,9529,1637,7140,2389,42178.75,0.214
31788,2011,27029,2287,11031,9389,1642,6830,2559,43200.0,0.232
31788,2012,28148,2452,11330,9600,1730,6983,2617,44124.0,0.231
31788,2013,28174,2385,11168,9577,1591,6889,2688,43994.5,0.241
31788,2014,27580,2253,10919,9444,1475,6464,2980,42842.75,0.273
31788,2015,27468,2235,10979,9458,1521,6221,3237,43914.0,0.295
31788,2016,27144,2211,11162,9695,1467,6096,3599,43630.5,0.322
31788,2017,27074,2200,11232,9788,1444,6475,3313,43543.75,0.295
31788,2018,26643,2251,11389,9833,1556,6515,3318,45159.0,0.291
31788,2019,26415,2105,11109,9634,1475,6680,2954,47305.5,0.266
31789,2010,16561,1333,7525,6360,1165,4410,1950,36737.33,0.259
31789,2011,16403,1394,7520,6295,1225,4200,2095,36678.67,0.279
31789,2012,16776,1411,7422,6217,1205,4339,1878,37474.0,0.253
31789,2013,16324,1192,7220,5946,1274,4109,1837,38305.0,0.254
31789,2014,16824,1417,7174,6010,1164,4123,1887,38500.67,0.263
31789,2015,16569,1424,7222,5932,1290,3847,2085,36978.0,0.289
31789,2016,16742,1426,7365,5968,1397,3976,1992,40682.67,0.27
31789,2017,16919,1529,7394,5905,1489,3999,1906,41657.67,0.258
31789,2018,16926,1560,7351,6063,1288,4035,2028,43074.0,0.276
31789,2019,16817,1331,7179,5898,1281,4177,1721,45428.0,0.24
31790,2010,18968,1202,8077,6823,1254,4604,2219,37966.75,0.275
31790,2011,18863,1284,8083,6802,1281,4516,2286,39000.0,0.283
31790,2012,18989,1468,8109,6836,1273,4741,2095,39635.25,0.258
31790,2013,18300,1442,7995,6618,1377,4630,1988,39707.75,0.249
31790,2014,18322,1786,7845,6634,1211,4636,1998,36736.25,0.255
31790,2015,18069,1744,7743,6516,1227,4375,2141,38374.5,0.277
31790,2016,18386,1711,7825,6510,1315,4470,2040,40380.75,0.261
31790,2017,18504,1651,7880,6475,1405,4376,2099,40380.0,0.266
31790,2018,19104,1607,7902,6737,1165,4506,2231,44329.75,0.282
31790,2019,19066,1407,7880,6660,1220,4507,2153,48701.5,0.273
31792,2010,41758,4350,17294,14794,2500,10539,4255,46666.0,0.246
31792,2011,41989,4348,17650,15143,2507,10466,4677,47304.0,0.265
31792,2012,43398,4325,17636,15331,2305,10085,5246,48206.2,0.297
31792,2013,42898,4022,17146,14882,2264,9321,5561,45871.8,0.324
31792,2014,42975,4692,17278,15300,1978,9540,5760,48977.4,0.333
31792,2015,44185,4514,17329,15616,1713,9455,6161,48637.4,0.356
31792,2016,43482,4773,17397,15839,1558,9176,6663,48064.6,0.383
31792,2017,43417,5052,17382,15807,1575,9392,6415,49939.4,0.369
31792,2018,44908,5783,18035,16378,1657,10078,6300,53610.4,0.349
31792,2019,44411,5451,17786,16167,1619,10057,6110,55946.6,0.344
31793,2010,24733,2228,10049,8617,1432,6160,2457,44684.0,0.245
31793,2011,25160,2196,10048,8659,1389,6063,2596,47346.67,0.258
31793,2012,26152,2367,10359,8933,1426,5983,2950,48791.0,0.285
31793,2013,25581,2225,10057,8686,1371,5824,2862,46899.0,0.285
31793,2014,25170,2205,9764,8632,1132,5446,3186,47221.33,0.326
31793,2015,25663,2185,9937,8887,1050,5327,3560,49600.67,0.358
31793,2016,25713,2325,10115,9158,957,5031,4127,48683.0,0.408
31793,2017,25788,2359,10103,9187,916,5382,3805,47662.33,0.377
31793,2018,25873,2474,10412,9340,1072,5512,3828,50858.33,0.368
31793,2019,25370,2512,10365,9328,1037,5773,3555,53040.67,0.343
31794,2010,40893,4493,17611,14820,2791,10173,4647,43563.17,0.264
31794,2011,41221,4427,17842,15035,2807,10089,4946,44108.17,0.277
31794,2012,42040,4298,17658,15008,2650,9628,5380,44426.0,0.305
31794,2013,40942,3980,17165,14469,2696,9043,5426,43269.0,0.316
31794,2014,41621,4792,17031,14846,2185,9180,5666,44118.17,0.333
31794,2015,42428,4886,17062,15191,1871,9145,6046,45607.33,0.354
31794,2016,42853,4983,17154,15294,1860,9145,6149,47979.17,0.358
31794,2017,43872,5203,17197,15248,1949,9266,5982,49257.33,0.348
31794,2018,43609,5494,17344,15486,1858,9601,5885,52312.67,0.339
31794,2019,43298,5114,17291,15396,1895,9718,5678,54320.5,0.328
31795,2010,10911,799,4196,3678,518,2869,809,42514.0,0.193
31795,2011,10849,875,4153,3701,452,2743,958,42295.0,0.231
31795,2012,11957,918,4491,4021,470,2903,1118,45088.0,0.249
31795,2013,12155,933,4429,4004,425,2878,1126,44905.0,0.254
31795,2014,11791,849,4296,3880,416,2658,1222,45913.0,0.284
31795,2015,11751,710,4316,3900,416,2493,1407,44682.0,0.326
31795,2016,11342,720,4399,4033,366,2311,1722,43181.0,0.391
31795,2017,10651,758,4291,3973,318,2457,1516,42919.0,0.353
31795,2018,11388,971,4557,4156,401,2619,1537,46799.0,0.337
31795,2019,11099,932,4400,4031,369,2627,1404,49531.0,0.319
31798,2010,15817,1526,6075,5368,707,4202,1166,46667.0,0.192
31798,2011,15993,1919,6289,5573,716,4363,1210,47577.75,0.192
31798,2012,15723,1794,6323,5565,758,4397,1168,45782.75,0.185
31798,2013,15715,1779,6397,5744,653,4529,1215,45100.5,0.19
31798,2014,15800,1733,6360,5754,606,4524,1230,44910.0,0.193
31798,2015,15567,1662,6328,5708,620,4523,1185,45964.5,0.187
31798,2016,15624,1347,6312,5700,612,4518,1182,43475.0,0.187
31798,2017,15876,1453,6365,5796,569,4512,1284,49000.25,0.202
31798,2018,16585,1538,6529,5914,615,4662,1252,53260.75,0.192
31798,2019,16335,1702,6496,5822,674,4678,1144,58714.75,0.176
31799,2010,6281,647,3202,2672,530,1325,1347,36505.0,0.421
31799,2011,6527,625,3338,2704,634,1362,1342,41648.0,0.402
31799,2012,6392,635,3259,2631,628,1167,1464,41958.0,0.449
31799,2013,6116,495,3024,2404,620,969,1435,37589.0,0.475
31799,2014,6453,659,2977,2517,460,971,1546,43631.0,0.519
31799,2015,7272,662,3135,2724,411,1080,1644,43690.0,0.524
31799,2016,7657,920,3178,2841,337,978,1863,42318.0,0.586
31799,2017,7970,1014,3169,2845,324,1008,1837,40429.0,0.58
31799,2018,8092,1041,3355,3027,328,1149,1878,42075.0,0.56
31799,2019,7819,1086,3426,3084,342,1299,1785,44015.0,0.521
31801,2010,20281,2594,7569,6616,953,5506,1110,86364.33,0.147
31801,2011,20499,2584,7430,6637,793,5369,1268,79390.0,0.171
31801,2012,21663,2777,7824,6995,829,5488,1507,90704.0,0.193
31801,2013,21414,2765,7751,6984,767,5516,1468,84473.67,0.189
31801,2014,20702,2582,7488,6800,688,5114,1686,82975.33,0.225
31801,2015,20338,2551,7502,6848,654,4880,1968,84787.33,0.262
31801,2016,20062,2489,7653,7002,651,4684,2318,87841.0,0.303
31801,2017,19822,2450,7659,7037,622,5013,2024,92477.67,0.264
31801,2018,19701,2556,7794,7012,782,5042,1970,103689.33,0.253
31801,2019,19541,2664,7701,6986,715,5195,1791,106247.67,0.233
31803,2010,10911,799,4196,3678,518,2869,809,42514.0,0.193
31803,2011,10849,875,4153,3701,452,2743,958,42295.0,0.231
31803,2012,11957,918,4491,4021,470,2903,1118,45088.0,0.249
31803,2013,12155,933,4429,4004,425,2878,1126,44905.0,0.254
31803,2014,11791,849,4296,3880,416,2658,1222,45913.0,0.284
31803,2015,11751,710,4316,3900,416,2493,1407,44682.0,0.326
31803,2016,11342,720,4399,4033,366,2311,1722,43181.0,0.391
31803,2017,10651,758,4291,3973,318,2457,1516,42919.0,0.353
31803,2018,11388,971,4557,4156,401,2619,1537,46799.0,0.337
31803,2019,11099,932,4400,4031,369,2627,1404,49531.0,0.319
31805,2010,1735,931,746,720,26,520,200,132917.0,0.268
31805,2011,1695,871,721,696,25,528,168,136429.0,0.233
31805,2012,1720,957,711,679,32,544,135,160662.0,0.19
31805,2013,1838,1004,707,707,0,554,153,159362.0,0.216
31805,2014,1853,1045,758,758,0,576,182,130385.0,0.24
31805,2015,1908,1106,754,731,23,571,160,153177.0,0.212
31805,2016,2006,1198,842,796,46,573,223,162500.0,0.265
31805,2017,2076,1231,840,785,55,580,205,174526.0,0.244
31805,2018,2141,1313,845,799,46,601,198,184875.0,0.234
31805,2019,1997,1192,803,737,66,550,187,170096.0,0.233
31806,2010,17052,4254,7299,6577,722,4652,1925,65267.5,0.264
31806,2011,16583,4312,7205,6434,771,4485,1949,62850.5,0.271
31806,2012,17764,4234,7474,6732,742,4596,2136,66893.0,0.286
31806,2013,18236,4464,7415,6783,632,4689,2094,69515.0,0.282
31806,2014,17892,4431,7279,6634,645,4543,2091,73506.5,0.287
31806,2015,18029,4556,7331,6825,506,4525,2300,72833.5,0.314
31806,2016,17617,4603,7384,6930,454,4288,2642,74613.0,0.358
31806,2017,16933,4577,7162,6750,412,4402,2348,79506.5,0.328
31806,2018,17679,4851,7392,6882,510,4482,2400,87485.0,0.325
31806,2019,17274,4772,7206,6727,479,4568,2159,103771.0,0.3
31808,2010,17601,2948,6519,6084,435,4826,1258,58092.5,0.193
31808,2011,18571,3411,6908,6439,469,4920,1519,59109.5,0.22
31808,2012,19301,3698,7227,6668,559,5193,1475,56521.5,0.204
31808,2013,19219,3607,7462,6741,721,5012,1729,51679.0,0.232
31808,2014,18852,3689,7487,6729,758,5049,1680,51414.5,0.224
31808,2015,19551,4310,7745,6892,853,5148,1744,51045.0,0.225
31808,2016,20594,5065,7847,6940,907,5005,1935,51117.5,0.247
31808,2017,21764,4978,8143,7211,932,4956,2255,51952.0,0.277
31808,2018,22319,5656,8075,7345,730,5511,1834,57392.5,0.227
31808,2019,24931,6222,8487,7984,503,5475,2509,61937.5,0.296
31810,2010,7541,782,2651,2267,384,1966,301,55033.0,0.114
31810,2011,7784,696,2557,2254,303,1958,296,58097.0,0.116
31810,2012,7803,814,2609,2281,328,1913,368,59327.0,0.141
31810,2013,7310,797,2604,2278,326,1977,301,58203.0,0.116
31810,2014,6926,697,2491,2235,256,1817,418,52120.0,0.168
31810,2015,6640,813,2486,2263,223,1754,509,60430.0,0.205
31810,2016,6714,685,2538,2284,254,1742,542,60550.0,0.214
31810,2017,7167,587,2643,2369,274,1917,452,59639.0,0.171
31810,2018,6393,462,2500,2157,343,1744,413,63701.0,0.165
31810,2019,6452,494,2539,2213,326,1847,366,65576.0,0.144
31812,2010,18452,1581,6847,5945,902,4835,1110,48773.5,0.162
31812,2011,18633,1571,6710,5955,755,4701,1254,50196.0,0.187
31812,2012,19760,1732,7100,6302,798,4816,1486,52207.5,0.209
31812,2013,19465,1730,7033,6282,751,4855,1427,51554.0,0.203
31812,2014,18717,1546,6787,6115,672,4475,1640,49016.5,0.242
31812,2015,18391,1523,6802,6163,639,4247,1916,52556.0,0.282
31812,2016,18056,1405,6937,6317,620,4053,2264,51865.5,0.326
31812,2017,17818,1345,6934,6342,592,4374,1968,51279.0,0.284
31812,2018,17781,1433,7057,6313,744,4363,1950,55250.0,0.276
31812,2019,17551,1426,6939,6244,695,4474,1770,57553.5,0.255
31816,2010,8835,778,4319,3584,735,2305,1279,35584.0,0.296
31816,2011,8396,716,4321,3434,887,2129,1305,36204.0,0.302
31816,2012,8388,720,4230,3298,932,2167,1131,36040.5,0.267
31816,2013,8709,655,4135,3295,840,2034,1261,36435.0,0.305
31816,2014,8863,707,4132,3329,803,1989,1340,36669.0,0.324
31816,2015,9077,712,4177,3295,882,1974,1321,35272.0,0.316
31816,2016,9088,806,4225,3378,847,2043,1335,35395.5,0.316
31816,2017,9256,855,4298,3446,852,2101,1345,35808.5,0.313
31816,2018,8862,818,4332,3520,812,2152,1368,35068.0,0.316
31816,2019,8864,679,4170,3390,780,2206,1184,37057.5,0.284
31820,2010,5902,2788,2732,2466,266,1694,772,117287.5,0.283
31820,2011,5813,2701,2689,2429,260,1626,803,104514.0,0.299
31820,2012,5853,2817,2697,2456,241,1698,758,122959.0,0.281
31820,2013,5629,2694,2674,2383,291,1570,813,113604.0,0.304
31820,2014,5889,2890,2675,2397,278,1563,834,110506.0,0.312
31820,2015,6014,2955,2669,2462,207,1648,814,110214.5,0.305
31820,2016,6352,3029,2773,2582,191,1673,909,113040.0,0.328
31820,2017,6386,3039,2789,2575,214,1658,917,124521.0,0.329
31820,2018,6364,3034,2786,2645,141,1667,978,137971.5,0.351
31820,2019,6361,3174,2827,2700,127,1670,1030,142794.0,0.364
31822,2010,3219,248,1517,1188,329,766,422,39630.0,0.278
31822,2011,2972,200,1531,1123,408,754,369,40795.0,0.241
31822,2012,3037,208,1600,1198,402,867,331,39695.0,0.207
31822,2013,3243,292,1602,1259,343,867,392,39362.0,0.245
31822,2014,3332,395,1563,1242,321,825,417,40395.0,0.267
31822,2015,3539,421,1535,1242,293,876,366,39781.0,0.238
31822,2016,3641,505,1501,1289,212,894,395,37989.0,0.263
31822,2017,4050,513,1549,1394,155,894,500,38648.0,0.323
31822,2018,3775,475,1536,1365,171,948,417,37414.0,0.271
31822,2019,3811,439,1507,1359,148,913,446,37976.0,0.296
31824,2010,10911,799,4196,3678,518,2869,809,42514.0,0.193
31824,2011,10849,875,4153,3701,452,2743,958,42295.0,0.231
31824,2012,11957,918,4491,4021,470,2903,1118,45088.0,0.249
31824,2013,12155,933,4429,4004,425,2878,1126,44905.0,0.254
31824,2014,11791,849,4296,3880,416,2658,1222,45913.0,0.284
31824,2015,11751,710,4316,3900,416,2493,1407,44682.0,0.326
31824,2016,11342,720,4399,4033,366,2311,1722,43181.0,0.391
31824,2017,10651,758,4291,3973,318,2457,1516,42919.0,0.353
31824,2018,11388,971,4557,4156,401,2619,1537,46799.0,0.337
31824,2019,11099,932,4400,4031,369,2627,1404,49531.0,0.319
31825,2010,10911,799,4196,3678,518,2869,809,42514.0,0.193
31825,2011,10849,875,4153,3701,452,2743,958,42295.0,0.231
31825,2012,11957,918,4491,4021,470,2903,1118,45088.0,0.249
31825,2013,12155,933,4429,4004,425,2878,1126,44905.0,0.254
31825,2014,11791,849,4296,3880,416,2658,1222,45913.0,0.284
31825,2015,11751,710,4316,3900,416,2493,1407,44682.0,0.326
31825,2016,11342,720,4399,4033,366,2311,1722,43181.0,0.391
31825,2017,10651,758,4291,3973,318,2457,1516,42919.0,0.353
31825,2018,11388,971,4557,4156,401,2619,1537,46799.0,0.337
31825,2019,11099,932,4400,4031,369,2627,1404,49531.0,0.319
31827,2010,18452,1581,6847,5945,902,4835,1110,48773.5,0.162
31827,2011,18633,1571,6710,5955,755,4701,1254,50196.0,0.187
31827,2012,19760,1732,7100,6302,798,4816,1486,52207.5,0.209
31827,2013,19465,1730,7033,6282,751,4855,1427,51554.0,0.203
31827,2014,18717,1546,6787,6115,672,4475,1640,49016.5,0.242
31827,2015,18391,1523,6802,6163,639,4247,1916,52556.0,0.282
31827,2016,18056,1405,6937,6317,620,4053,2264,51865.5,0.326
31827,2017,17818,1345,6934,6342,592,4374,1968,51279.0,0.284
31827,2018,17781,1433,7057,6313,744,4363,1950,55250.0,0.276
31827,2019,17551,1426,6939,6244,695,4474,1770,57553.5,0.255
31829,2010,1829,1013,722,671,51,671,0,161546.0,0.0
31829,2011,1866,1013,720,682,38,668,14,137778.0,0.019
31829,2012,1903,1045,724,693,31,672,21,167697.0,0.029
31829,2013,1949,1035,718,702,16,661,41,150313.0,0.057
31829,2014,1985,1036,701,685,16,639,46,150893.0,0.066
31829,2015,1947,1028,700,685,15,633,52,149250.0,0.074
31829,2016,2006,1084,716,685,31,631,54,159792.0,0.075
31829,2017,2004,1105,725,695,30,639,56,174875.0,0.077
31829,2018,1920,1123,737,699,38,679,20,200568.0,0.027
31829,2019,1990,1238,762,742,20,721,21,203636.0,0.028
31830,2010,8835,778,4319,3584,735,2305,1279,35584.0,0.296
31830,2011,8396,716,4321,3434,887,2129,1305,36204.0,0.302
31830,2012,8388,720,4230,3298,932,2167,1131,36040.5,0.267
31830,2013,8709,655,4135,3295,840,2034,1261,36435.0,0.305
31830,2014,8863,707,4132,3329,803,1989,1340,36669.0,0.324
31830,2015,9077,712,4177,3295,882,1974,1321,35272.0,0.316
31830,2016,9088,806,4225,3378,847,2043,1335,35395.5,0.316
31830,2017,9256,855,4298,3446,852,2101,1345,35808.5,0.313
31830,2018,8862,818,4332,3520,812,2152,1368,35068.0,0.316
31830,2019,8864,679,4170,3390,780,2206,1184,37057.5,0.284
31831,2010,18452,1581,6847,5945,902,4835,1110,48773.5,0.162
31831,2011,18633,1571,6710,5955,755,4701,1254,50196.0,0.187
31831,2012,19760,1732,7100,6302,798,4816,1486,52207.5,0.209
31831,2013,19465,1730,7033,6282,751,4855,1427,51554.0,0.203
31831,2014,18717,1546,6787,6115,672,4475,1640,49016.5,0.242
31831,2015,18391,1523,6802,6163,639,4247,1916,52556.0,0.282
31831,2016,18056,1405,6937,6317,620,4053,2264,51865.5,0.326
31831,2017,17818,1345,6934,6342,592,4374,1968,51279.0,0.284
31831,2018,17781,1433,7057,6313,744,4363,1950,55250.0,0.276
31831,2019,17551,1426,6939,6244,695,4474,1770,57553.5,0.255
31832,2010,10911,799,4196,3678,518,2869,809,42514.0,0.193
31832,2011,10849,875,4153,3701,452,2743,958,42295.0,0.231
31832,2012,11957,918,4491,4021,470,2903,1118,45088.0,0.249
31832,2013,12155,933,4429,4004,425,2878,1126,44905.0,0.254
31832,2014,11791,849,4296,3880,416,2658,1222,45913.0,0.284
31832,2015,11751,710,4316,3900,416,2493,1407,44682.0,0.326
31832,2016,11342,720,4399,4033,366,2311,1722,43181.0,0.391
31832,2017,10651,758,4291,3973,318,2457,1516,42919.0,0.353
31832,2018,11388,971,4557,4156,401,2619,1537,46799.0,0.337
31832,2019,11099,932,4400,4031,369,2627,1404,49531.0,0.319
31833,2010,14945,1421,5137,4675,462,4308,367,62265.0,0.071
31833,2011,14901,1264,5150,4671,479,4138,533,63502.5,0.103
31833,2012,14666,1455,5135,4761,374,4205,556,62187.5,0.108
31833,2013,14397,1605,5177,4757,420,4155,602,60995.0,0.116
31833,2014,14233,1904,5419,4990,429,4368,622,62484.0,0.115
31833,2015,13991,2167,5500,5039,461,4307,732,60897.0,0.133
31833,2016,13647,2429,5469,5076,393,4313,763,58790.5,0.14
31833,2017,14147,2500,5658,5174,484,4414,760,63738.0,0.134
31833,2018,14965,2470,5708,5274,434,4543,731,67355.0,0.128
31833,2019,15234,2324,5681,5321,360,4571,750,68366.5,0.132
31836,2010,10911,799,4196,3678,518,2869,809,42514.0,0.193
31836,2011,10849,875,4153,3701,452,2743,958,42295.0,0.231
31836,2012,11957,918,4491,4021,470,2903,1118,45088.0,0.249
31836,2013,12155,933,4429,4004,425,2878,1126,44905.0,0.254
31836,2014,11791,849,4296,3880,416,2658,1222,45913.0,0.284
31836,2015,11751,710,4316,3900,416,2493,1407,44682.0,0.326
31836,2016,11342,720,4399,4033,366,2311,1722,43181.0,0.391
31836,2017,10651,758,4291,3973,318,2457,1516,42919.0,0.353
31836,2018,11388,971,4557,4156,401,2619,1537,46799.0,0.337
31836,2019,11099,932,4400,4031,369,2627,1404,49531.0,0.319
31901,2010,12754,3593,8667,6788,1879,2488,4300,39455.0,0.496
31901,2011,12434,3706,8660,6699,1961,2559,4140,39156.4,0.478
31901,2012,12204,3735,8555,6635,1920,2331,4304,38275.2,0.503
31901,2013,12198,3763,8599,6698,1901,2243,4455,38426.0,0.518
31901,2014,12135,3673,8648,6705,1943,2273,4432,39649.8,0.512
31901,2015,13637,4050,8763,7130,1633,2453,4677,40164.8,0.534
31901,2016,13738,4124,8965,7263,1702,2212,5051,39966.2,0.563
31901,2017,13976,4532,9070,7354,1716,2489,4865,43570.2,0.536
31901,2018,14069,4826,9144,7450,1694,2536,4914,45747.0,0.537
31901,2019,14599,5301,9128,7555,1573,2742,4813,49268.0,0.527
31902,2010,2191,555,1393,1083,310,705,378,46354.0,0.271
31902,2011,2148,606,1394,1089,305,692,397,47264.0,0.285
31902,2012,2246,622,1370,1104,266,645,459,47167.0,0.335
31902,2013,2144,571,1362,1060,302,600,460,45515.0,0.338
31902,2014,2189,605,1401,1100,301,641,459,48447.0,0.328
31902,2015,2309,558,1436,1157,279,716,441,47691.0,0.307
31902,2016,2399,538,1462,1177,285,713,464,49638.0,0.317
31902,2017,2420,564,1489,1196,293,754,442,51848.0,0.297
31902,2018,2376,615,1413,1149,264,747,402,56308.0,0.285
31902,2019,2365,707,1406,1148,258,667,481,60333.0,0.342
31903,2010,4640,2723,3021,2562,459,1535,1027,66392.5,0.34
31903,2011,4579,2662,3118,2702,416,1395,1307,62383.0,0.419
31903,2012,4649,2967,3134,2770,364,1469,1301,68707.0,0.415
31903,2013,4747,3052,3177,2841,336,1412,1429,60287.0,0.45
31903,2014,5070,3225,3187,2940,247,1528,1412,69436.5,0.443
31903,2015,5227,3208,3232,2976,256,1556,1420,74372.0,0.439
31903,2016,5277,3284,3271,2950,321,1614,1336,79514.5,0.408
31903,2017,5576,3516,3356,2931,425,1667,1264,89214.5,0.377
31903,2018,5856,3721,3452,2976,476,1749,1227,102779.5,0.355
31903,2019,6019,3901,3540,3114,426,1854,1260,112477.5,0.356
31904,2010,39760,11543,18902,16787,2115,10949,5838,65025.75,0.309
31904,2011,40177,12224,19101,16958,2143,11056,5902,66318.12,0.309
31904,2012,40728,12256,19043,16931,2112,10846,6085,66057.5,0.32
31904,2013,41190,12252,19305,17167,2138,10812,6355,65365.12,0.329
31904,2014,41066,12427,19213,17116,2097,10912,6204,65391.5,0.323
31904,2015,41794,13206,19425,17285,2140,11089,6196,65990.88,0.319
31904,2016,43206,14061,19621,17458,2163,11078,6380,67096.62,0.325
31904,2017,44617,14102,19938,17550,2388,11086,6464,71253.0,0.324
31904,2018,45267,15298,19766,17660,2106,11620,6040,74967.38,0.306
31904,2019,48022,16195,20362,18517,1845,11725,6792,81804.25,0.334
31905,2010,1735,931,746,720,26,520,200,132917.0,0.268
31905,2011,1695,871,721,696,25,528,168,136429.0,0.233
31905,2012,1720,957,711,679,32,544,135,160662.0,0.19
31905,2013,1838,1004,707,707,0,554,153,159362.0,0.216
31905,2014,1853,1045,758,758,0,576,182,130385.0,0.24
31905,2015,1908,1106,754,731,23,571,160,153177.0,0.212
31905,2016,2006,1198,842,796,46,573,223,162500.0,0.265
31905,2017,2076,1231,840,785,55,580,205,174526.0,0.244
31905,2018,2141,1313,845,799,46,601,198,184875.0,0.234
31905,2019,1997,1192,803,737,66,550,187,170096.0,0.233
31906,2010,8570,2708,7230,4946,2284,2015,2931,32259.25,0.405
31906,2011,9034,3065,7201,4975,2226,2018,2957,32156.5,0.411
31906,2012,9403,3378,7237,5045,2192,2074,2971,32498.25,0.411
31906,2013,9918,3325,7390,4932,2458,1910,3022,34568.5,0.409
31906,2014,10954,3421,7659,5294,2365,2013,3281,35938.25,0.428
31906,2015,12647,3766,7775,5636,2139,1982,3654,39488.0,0.47
31906,2016,12945,4043,7806,5601,2205,1915,3686,41692.25,0.472
31906,2017,13506,4329,8126,5750,2376,2099,3651,45977.5,0.449
31906,2018,14069,4577,8557,5979,2578,2173,3806,47344.5,0.445
31906,2019,14594,5339,9061,6396,2665,2247,4149,49332.5,0.458
31907,2010,4100,789,1252,1027,225,237,790,26438.0,0.631
31907,2011,3807,706,1218,1024,194,319,705,30662.0,0.579
31907,2012,3308,654,1132,958,174,266,692,27447.0,0.611
31907,2013,2931,690,1044,870,174,307,563,35250.0,0.539
31907,2014,2851,727,1090,907,183,319,588,32279.0,0.539
31907,2015,2785,700,1093,960,133,344,616,37627.0,0.564
31907,2016,2587,579,1089,904,185,322,582,38068.0,0.534
31907,2017,2640,630,1113,871,242,360,511,51250.0,0.459
31907,2018,2463,566,1144,878,266,314,564,47917.0,0.493
31907,2019,2409,658,1156,885,271,378,507,68618.0,0.439
31909,2010,29666,12185,13732,12592,1140,9364,3228,99007.67,0.235
31909,2011,28997,12152,13559,12273,1286,9200,3073,96595.83,0.227
31909,2012,29308,12306,13424,12104,1320,8934,3170,100275.0,0.236
31909,2013,29334,12648,13423,12146,1277,8900,3246,99435.17,0.242
31909,2014,29798,12999,13321,12146,1175,8826,3320,101046.17,0.249
31909,2015,29903,13262,13254,12154,1100,8968,3186,101581.33,0.24
31909,2016,30573,13746,13472,12462,1010,9205,3257,104427.67,0.242
31909,2017,30655,13719,13402,12273,1129,9221,3052,115439.17,0.228
31909,2018,30851,13752,13347,12488,859,9284,3204,122078.67,0.24
31909,2019,31468,14267,13784,12888,896,9478,3410,128651.83,0.247
31999,2010,1683,60,1352,673,679,195,478,20350.0,0.354
31999,2011,1518,103,1302,681,621,186,495,19529.0,0.38
31999,2012,1141,123,1272,553,719,187,366,16034.0,0.288
31999,2013,1172,111,1224,497,727,143,354,19840.0,0.289
31999,2014,1263,104,1169,508,661,139,369,21486.0,0.316
31999,2015,1244,102,1163,500,663,122,378,23088.0,0.325
31999,2016,1400,90,1117,495,622,136,359,26793.0,0.321
31999,2017,1500,107,1167,534,633,147,387,27674.0,0.332
31999,2018,1459,107,1198,560,638,134,426,26705.0,0.356
31999,2019,1268,127,1180,525,655,118,407,26683.0,0.345
39813,2010,17849,1724,7164,6321,843,5174,1147,51949.0,0.16
39813,2011,18397,1724,7358,6539,819,5116,1423,51827.5,0.193
39813,2012,20073,1769,7807,7008,799,5307,1701,53266.5,0.218
39813,2013,20268,1942,7826,7057,769,5333,1724,52656.0,0.22
39813,2014,20331,2078,7795,7044,751,5224,1820,53805.5,0.233
39813,2015,20681,2048,7877,7095,782,5071,2024,50994.0,0.257
39813,2016,20307,2160,7864,7190,674,4908,2282,52092.5,0.29
39813,2017,19525,2342,7865,7221,644,5223,1998,54393.0,0.254
39813,2018,20922,2580,8313,7659,654,5670,1989,59106.5,0.239
39813,2019,21244,2715,8342,7796,546,5864,1932,61907.5,0.232
39815,2010,22589,1911,10576,8628,1948,6316,2312,41247.0,0.219
39815,2011,23467,2233,10784,8638,2146,6462,2176,43027.25,0.202
39815,2012,23525,2536,10810,8867,1943,6680,2187,44163.0,0.202
39815,2013,24274,2825,10930,9065,1865,6898,2167,43408.0,0.198
39815,2014,24288,2961,11296,9238,2058,6938,2300,44254.0,0.204
39815,2015,24590,3155,11367,9204,2163,7018,2186,45184.75,0.192
39815,2016,24514,3469,11221,9266,1955,6968,2298,43258.75,0.205
39815,2017,24717,3655,11409,9355,2054,6927,2428,44844.75,0.213
39815,2018,24075,3427,11458,9222,2236,6817,2405,46414.25,0.21
39815,2019,24311,3391,11635,9394,2241,6989,2405,47815.0,0.207
39817,2010,36374,2775,16186,13394,2792,9417,3977,40287.29,0.246
39817,2011,36961,3238,16449,13451,2998,9590,3861,41793.86,0.235
39817,2012,37120,3656,16515,13674,2841,10017,3657,42589.86,0.221
39817,2013,37398,3948,16564,13708,2856,10161,3547,42879.14,0.214
39817,2014,37607,4503,16682,13809,2873,10215,3594,41248.0,0.215
39817,2015,37703,4633,16674,13790,2884,10083,3707,42592.43,0.222
39817,2016,37809,4860,16611,13805,2806,10090,3715,42881.86,0.224
39817,2017,38236,5043,16862,13867,2995,9950,3917,43842.29,0.232
39817,2018,38222,4741,16893,14064,2829,10059,4005,46904.57,0.237
39817,2019,38856,4534,17056,14261,2795,10328,3933,50372.71,0.231
39818,2010,8023,399,3354,2859,495,1733,1126,36596.5,0.336
39818,2011,7884,406,3353,2818,535,1691,1127,38788.5,0.336
39818,2012,7564,569,3317,2719,598,1702,1017,39252.5,0.307
39818,2013,7442,613,3308,2708,600,1688,1020,38712.0,0.308
39818,2014,7029,681,3240,2711,529,1677,1034,32193.0,0.319
39818,2015,7038,611,3163,2637,526,1626,1011,36663.5,0.32
39818,2016,7091,586,3184,2631,553,1643,988,36138.5,0.31
39818,2017,6791,464,3235,2622,613,1584,1038,34758.0,0.321
39818,2018,7265,390,3347,2829,518,1675,1154,40409.5,0.345
39818,2019,7302,316,3364,2793,571,1623,1170,47330.5,0.348
39819,2010,42238,2895,18654,15487,3167,11132,4355,40451.88,0.233
39819,2011,42771,3219,18910,15339,3571,11106,4233,41935.12,0.224
39819,2012,42310,3713,19073,15538,3535,11484,4054,42176.62,0.213
39819,2013,42769,4081,19274,15897,3377,11739,4158,41764.12,0.216
39819,2014,42217,4461,19444,15882,3562,11499,4383,39832.88,0.225
39819,2015,42431,4576,19377,15801,3576,11525,4276,41301.5,0.221
39819,2016,42262,4926,19125,15819,3306,11439,4380,39884.75,0.229
39819,2017,42469,5084,19448,16070,3378,11484,4586,40760.62,0.236
39819,2018,42409,4873,19523,16152,3371,11494,4658,42667.75,0.239
39819,2019,43145,4744,19874,16414,3460,11665,4749,45799.62,0.239
39823,2010,40815,6636,16690,14533,2157,11309,3224,56694.0,0.193
39823,2011,42203,6575,17108,14888,2220,11358,3530,57329.2,0.206
39823,2012,43769,6998,17451,15332,2119,11508,3824,59137.4,0.219
39823,2013,43989,6945,17638,15355,2283,11452,3903,58473.2,0.221
39823,2014,45582,7913,17737,15936,1801,11706,4230,59705.8,0.238
39823,2015,45904,8089,17514,16011,1503,11543,4468,60849.4,0.255
39823,2016,46731,8322,17464,16035,1429,11732,4303,62474.4,0.246
39823,2017,46734,8307,17834,16429,1405,12399,4030,62825.4,0.226
39823,2018,46523,8645,18001,16711,1290,12699,4012,70584.6,0.223
39823,2019,46621,8932,18605,17345,1260,13018,4327,71924.0,0.233
39824,2010,14744,1919,5765,4995,770,4263,732,54924.0,0.127
39824,2011,15286,1827,5684,4971,713,4290,681,57517.5,0.12
39824,2012,15192,1906,5730,4982,748,4224,758,59529.0,0.132
39824,2013,14748,1881,5772,4914,858,4197,717,59084.0,0.124
39824,2014,14780,2017,5601,4958,643,4165,793,55766.5,0.142
39824,2015,14735,2129,5561,4983,578,4080,903,62918.5,0.162
39824,2016,15074,2102,5652,4991,661,4015,976,63700.0,0.173
39824,2017,15649,1966,5818,5133,685,4239,894,62594.0,0.154
39824,2018,15223,2025,5616,5025,591,4201,824,74373.0,0.147
39824,2019,14822,2247,5784,5176,608,4432,744,77549.0,0.129
39825,2010,10945,803,4723,3964,759,2871,1093,39337.0,0.231
39825,2011,10979,878,4730,3984,746,2825,1159,39211.5,0.245
39825,2012,11425,899,4792,4117,675,3039,1078,40018.0,0.225
39825,2013,10858,829,4687,3910,777,2942,968,40703.5,0.207
39825,2014,11293,1105,4605,3923,682,2959,964,41279.5,0.209
39825,2015,11031,1133,4580,3879,701,2749,1130,40085.5,0.247
39825,2016,11295,1125,4641,3879,762,2827,1052,44623.0,0.227
39825,2017,11713,1187,4645,3853,792,2792,1061,46002.0,0.228
39825,2018,11839,1217,4555,3908,647,2831,1077,48250.0,0.236
39825,2019,11764,1091,4516,3867,649,2884,983,50072.5,0.218
39828,2010,10911,799,4196,3678,518,2869,809,42514.0,0.193
39828,2011,10849,875,4153,3701,452,2743,958,42295.0,0.231
39828,2012,11957,918,4491,4021,470,2903,1118,45088.0,0.249
39828,2013,12155,933,4429,4004,425,2878,1126,44905.0,0.254
39828,2014,11791,849,4296,3880,416,2658,1222,45913.0,0.284
39828,2015,11751,710,4316,3900,416,2493,1407,44682.0,0.326
39828,2016,11342,720,4399,4033,366,2311,1722,43181.0,0.391
39828,2017,10651,758,4291,3973,318,2457,1516,42919.0,0.353
39828,2018,11388,971,4557,4156,401,2619,1537,46799.0,0.337
39828,2019,11099,932,4400,4031,369,2627,1404,49531.0,0.319
39834,2010,22589,1911,10576,8628,1948,6316,2312,41247.0,0.219
39834,2011,23467,2233,10784,8638,2146,6462,2176,43027.25,0.202
39834,2012,23525,2536,10810,8867,1943,6680,2187,44163.0,0.202
39834,2013,24274,2825,10930,9065,1865,6898,2167,43408.0,0.198
39834,2014,24288,2961,11296,9238,2058,6938,2300,44254.0,0.204
39834,2015,24590,3155,11367,9204,2163,7018,2186,45184.75,0.192
39834,2016,24514,3469,11221,9266,1955,6968,2298,43258.75,0.205
39834,2017,24717,3655,11409,9355,2054,6927,2428,44844.75,0.213
39834,2018,24075,3427,11458,9222,2236,6817,2405,46414.25,0.21
39834,2019,24311,3391,11635,9394,2241,6989,2405,47815.0,0.207
39836,2010,7541,782,2651,2267,384,1966,301,55033.0,0.114
39836,2011,7784,696,2557,2254,303,1958,296,58097.0,0.116
39836,2012,7803,814,2609,2281,328,1913,368,59327.0,0.141
39836,2013,7310,797,2604,2278,326,1977,301,58203.0,0.116
39836,2014,6926,697,2491,2235,256,1817,418,52120.0,0.168
39836,2015,6640,813,2486,2263,223,1754,509,60430.0,0.205
39836,2016,6714,685,2538,2284,254,1742,542,60550.0,0.214
39836,2017,7167,587,2643,2369,274,1917,452,59639.0,0.171
39836,2018,6393,462,2500,2157,343,1744,413,63701.0,0.165
39836,2019,6452,494,2539,2213,326,1847,366,65576.0,0.144
39837,2010,37256,3574,15860,13579,2281,9499,4080,43465.2,0.257
39837,2011,37320,3623,16017,13717,2300,9320,4397,43419.0,0.275
39837,2012,40267,3681,16612,14522,2090,9870,4652,44788.0,0.28
39837,2013,40459,3642,16590,14372,2218,9727,4645,44362.6,0.28
39837,2014,41215,4168,16500,14543,1957,9669,4874,45446.2,0.295
39837,2015,41548,4185,16373,14535,1838,9142,5393,43871.4,0.329
39837,2016,41690,4491,16419,14690,1729,9100,5590,46401.6,0.34
39837,2017,40834,4763,16356,14687,1669,9339,5348,48161.0,0.327
39837,2018,42049,5249,16784,15229,1555,9826,5403,51548.6,0.322
39837,2019,42118,5261,16790,15297,1493,10162,5135,54015.6,0.306
39841,2010,17849,1724,7164,6321,843,5174,1147,51949.0,0.16
39841,2011,18397,1724,7358,6539,819,5116,1423,51827.5,0.193
39841,2012,20073,1769,7807,7008,799,5307,1701,53266.5,0.218
39841,2013,20268,1942,7826,7057,769,5333,1724,52656.0,0.22
39841,2014,20331,2078,7795,7044,751,5224,1820,53805.5,0.233
39841,2015,20681,2048,7877,7095,782,5071,2024,50994.0,0.257
39841,2016,20307,2160,7864,7190,674,4908,2282,52092.5,0.29
39841,2017,19525,2342,7865,7221,644,5223,1998,54393.0,0.254
39841,2018,20922,2580,8313,7659,654,5670,1989,59106.5,0.239
39841,2019,21244,2715,8342,7796,546,5864,1932,61907.5,0.232
39842,2010,17227,3283,7123,6396,727,5341,1055,78107.0,0.148
39842,2011,19373,3511,7727,7067,660,5824,1243,76649.5,0.161
39842,2012,20836,3745,8063,7407,656,5975,1432,78773.5,0.178
39842,2013,21516,3868,8179,7510,669,6001,1509,79278.0,0.184
39842,2014,22026,4099,8144,7660,484,6065,1595,79417.0,0.196
39842,2015,22122,3967,8156,7694,462,6025,1669,78495.0,0.205
39842,2016,22362,4088,8080,7682,398,5912,1770,77299.5,0.219
39842,2017,22217,4122,8206,7754,452,5918,1836,82977.5,0.224
39842,2018,22441,4312,8280,7822,458,5676,2146,91851.5,0.259
39842,2019,22338,3652,8313,7674,639,5448,2226,102239.5,0.268
39846,2010,7541,782,2651,2267,384,1966,301,55033.0,0.114
39846,2011,7784,696,2557,2254,303,1958,296,58097.0,0.116
39846,2012,7803,814,2609,2281,328,1913,368,59327.0,0.141
39846,2013,7310,797,2604,2278,326,1977,301,58203.0,0.116
39846,2014,6926,697,2491,2235,256,1817,418,52120.0,0.168
39846,2015,6640,813,2486,2263,223,1754,509,60430.0,0.205
39846,2016,6714,685,2538,2284,254,1742,542,60550.0,0.214
39846,2017,7167,587,2643,2369,274,1917,452,59639.0,0.171
39846,2018,6393,462,2500,2157,343,1744,413,63701.0,0.165
39846,2019,6452,494,2539,2213,326,1847,366,65576.0,0.144
39851,2010,7541,782,2651,2267,384,1966,301,55033.0,0.114
39851,2011,7784,696,2557,2254,303,1958,296,58097.0,0.116
39851,2012,7803,814,2609,2281,328,1913,368,59327.0,0.141
39851,2013,7310,797,2604,2278,326,1977,301,58203.0,0.116
39851,2014,6926,697,2491,2235,256,1817,418,52120.0,0.168
39851,2015,6640,813,2486,2263,223,1754,509,60430.0,0.205
39851,2016,6714,685,2538,2284,254,1742,542,60550.0,0.214
39851,2017,7167,587,2643,2369,274,1917,452,59639.0,0.171
39851,2018,6393,462,2500,2157,343,1744,413,63701.0,0.165
39851,2019,6452,494,2539,2213,326,1847,366,65576.0,0.144
39852,2010,5183,338,2467,2057,410,1503,554,34844.0,0.225
39852,2011,5369,279,2418,1989,429,1388,601,35552.0,0.249
39852,2012,5394,348,2404,2029,375,1404,625,37064.0,0.26
39852,2013,5176,319,2361,1975,386,1367,608,32309.0,0.258
39852,2014,5003,244,2459,2063,396,1359,704,35225.0,0.286
39852,2015,4956,266,2436,1930,506,1310,620,36090.0,0.255
39852,2016,5091,320,2435,1971,464,1348,623,34385.0,0.256
39852,2017,4985,263,2427,1963,464,1353,610,34003.0,0.251
39852,2018,4957,293,2467,1895,572,1264,631,34644.0,0.256
39852,2019,4521,264,2459,1793,666,1168,625,33457.0,0.254
39854,2010,15082,1564,5302,4534,768,3932,602,55033.0,0.114
39854,2011,15568,1392,5114,4508,606,3916,592,58097.0,0.116
39854,2012,15606,1628,5218,4562,656,3826,736,59327.0,0.141
39854,2013,14620,1594,5208,4556,652,3954,602,58203.0,0.116
39854,2014,13852,1394,4982,4470,512,3634,836,52120.0,0.168
39854,2015,13280,1626,4972,4526,446,3508,1018,60430.0,0.205
39854,2016,13428,1370,5076,4568,508,3484,1084,60550.0,0.214
39854,2017,14334,1174,5286,4738,548,3834,904,59639.0,0.171
39854,2018,12786,924,5000,4314,686,3488,826,63701.0,0.165
39854,2019,12904,988,5078,4426,652,3694,732,65576.0,0.144
39862,2010,10911,799,4196,3678,518,2869,809,42514.0,0.193
39862,2011,10849,875,4153,3701,452,2743,958,42295.0,0.231
39862,2012,11957,918,4491,4021,470,2903,1118,45088.0,0.249
39862,2013,12155,933,4429,4004,425,2878,1126,44905.0,0.254
39862,2014,11791,849,4296,3880,416,2658,1222,45913.0,0.284
39862,2015,11751,710,4316,3900,416,2493,1407,44682.0,0.326
39862,2016,11342,720,4399,4033,366,2311,1722,43181.0,0.391
39862,2017,10651,758,4291,3973,318,2457,1516,42919.0,0.353
39862,2018,11388,971,4557,4156,401,2619,1537,46799.0,0.337
39862,2019,11099,932,4400,4031,369,2627,1404,49531.0,0.319
39867,2010,15082,1564,5302,4534,768,3932,602,55033.0,0.114
39867,2011,15568,1392,5114,4508,606,3916,592,58097.0,0.116
39867,2012,15606,1628,5218,4562,656,3826,736,59327.0,0.141
39867,2013,14620,1594,5208,4556,652,3954,602,58203.0,0.116
39867,2014,13852,1394,4982,4470,512,3634,836,52120.0,0.168
39867,2015,13280,1626,4972,4526,446,3508,1018,60430.0,0.205
39867,2016,13428,1370,5076,4568,508,3484,1084,60550.0,0.214
39867,2017,14334,1174,5286,4738,548,3834,904,59639.0,0.171
39867,2018,12786,924,5000,4314,686,3488,826,63701.0,0.165
39867,2019,12904,988,5078,4426,652,3694,732,65576.0,0.144
39870,2010,10911,799,4196,3678,518,2869,809,42514.0,0.193
39870,2011,10849,875,4153,3701,452,2743,958,42295.0,0.231
39870,2012,11957,918,4491,4021,470,2903,1118,45088.0,0.249
39870,2013,12155,933,4429,4004,425,2878,1126,44905.0,0.254
39870,2014,11791,849,4296,3880,416,2658,1222,45913.0,0.284
39870,2015,11751,710,4316,3900,416,2493,1407,44682.0,0.326
39870,2016,11342,720,4399,4033,366,2311,1722,43181.0,0.391
39870,2017,10651,758,4291,3973,318,2457,1516,42919.0,0.353
39870,2018,11388,971,4557,4156,401,2619,1537,46799.0,0.337
39870,2019,11099,932,4400,4031,369,2627,1404,49531.0,0.319
39877,2010,10911,799,4196,3678,518,2869,809,42514.0,0.193
39877,2011,10849,875,4153,3701,452,2743,958,42295.0,0.231
39877,2012,11957,918,4491,4021,470,2903,1118,45088.0,0.249
39877,2013,12155,933,4429,4004,425,2878,1126,44905.0,0.254
39877,2014,11791,849,4296,3880,416,2658,1222,45913.0,0.284
39877,2015,11751,710,4316,3900,416,2493,1407,44682.0,0.326
39877,2016,11342,720,4399,4033,366,2311,1722,43181.0,0.391
39877,2017,10651,758,4291,3973,318,2457,1516,42919.0,0.353
39877,2018,11388,971,4557,4156,401,2619,1537,46799.0,0.337
39877,2019,11099,932,4400,4031,369,2627,1404,49531.0,0.319
39897,2010,17406,1573,8109,6571,1538,4813,1758,43381.33,0.217
39897,2011,18098,1954,8366,6649,1717,5074,1575,45519.0,0.188
39897,2012,18131,2188,8406,6838,1568,5276,1562,46529.33,0.186
39897,2013,19098,2506,8569,7090,1479,5531,1559,47107.67,0.182
39897,2014,19285,2717,8837,7175,1662,5579,1596,47263.67,0.181
39897,2015,19634,2889,8931,7274,1657,5708,1566,48216.33,0.175
39897,2016,19423,3149,8786,7295,1491,5620,1675,46216.67,0.191
39897,2017,19732,3392,8982,7392,1590,5574,1818,48458.67,0.202
39897,2018,19118,3134,8991,7327,1664,5553,1774,50337.67,0.197
39897,2019,19790,3127,9176,7601,1575,5821,1780,52601.0,0.194
39901,2010,4287,80,1204,1110,94,28,1082,26584.0,0.899
39901,2011,3619,50,985,892,93,51,841,30309.0,0.854
39901,2012,3662,55,1097,949,148,92,857,29154.0,0.781
39901,2013,4332,34,1228,1059,169,119,940,31462.0,0.765
39901,2014,4429,34,1270,1100,170,72,1028,28939.0,0.809
39901,2015,4005,53,1178,1026,152,56,970,25034.0,0.823
39901,2016,3451,63,1041,918,123,22,896,25000.0,0.861
39901,2017,3555,62,928,843,85,0,843,26523.0,0.908
39901,2018,3308,71,898,814,84,0,814,26630.0,0.906
39901,2019,3002,72,857,780,77,0,780,28242.0,0.91
